אָב|av
אַבָּא|aba
אָבִיב|aviv
אֵב|ev
לֶאֱבוֹד|le'evod
לְהֵיאָבֵד|lehe'aved
לְאַבֵּד|le'abed
לְהִתְאַבֵּד|lehit'abed
לְהַאֲבִיד|leha'avid
הִתְאַבְּדוּת|hit'abdut
אִיבּוּד|ibud
אֲבֵדָה|aveda
אָבוּד|avud
לְאַבְחֵן|le'avchen
אִיבְחוּן|ivchun
לְאַבְטֵחַ|le'avteach
אִיבְטוּחַ|ivtuach
אֲבַטִּיחַ|avatiach
לֶאֱבוֹת|le'evot
אֵבֶל|evel
לֶאֱבוֹל|le'evol
אֲבָל|aval
לְהִתְאַבֵּל|lehit'abel
לְהִתְאַבֵּן|lehit'aben
אֶבֶן|even
לְהַאֲבִיס|leha'avis
לְהֵיאָבֵק|lehe'avek
מַאֲבָק|ma'avak
לְאַבֵּק|le'abek
אָבָק|avak
לְהִתְאַבֵּק|lehit'abek
לְהִתְאַבֵּק|lehit'abek
מְאוּבָּק|me'ubak
אִיבּוּק|ibuk
לְהַאֲבִיק|leha'avik
אַבִּיר|abir
לֶאֱגוֹד|le'egod
לְאַגֵּד|le'aged
לְהֵיאָגֵד|lehe'aged
לְהִתְאַגֵּד|lehit'aged
אֶגֶד|eged
אֲגוּדָּה|aguda
אֲגִידָה|agida
אוּגְדָּה|ugda
הִתְאַגְּדוּת|hit'agdut
אִיגּוּד|igud
תַּאֲגִיד|ta'agid
אֱגוֹז|egoz
אֲגַם|agam
לֶאֱגוֹף|le'egof
לְאַגֵּף|le'agef
אֲגַף|agaf
אִיגּוּף|iguf
אֶגְרוֹן|egron
מַאֲגָר|ma'agar
אִיגֶּרֶת|igeret
לֶאֱגוֹר|le'egor
לְהִתְאַגְרֵף|lehit'agref
אָדִיב|adiv
אָדוֹן|adon
לְהִתְאַדּוֹת|lehit'adot
אִידּוּי|iduy
הִתְאַדּוּת|hit'adut
אֵד|ed
לְאַדּוֹת|le'adot
מַאֲדִים|ma'adim
אֲדַמְדַּם|adamdam
אַדֶּמֶת|ademet
אָדָם|adam
אָדוֹם|adom
אֲדָמָה|adama
לְהַאֲדִים|leha'adim
אוֹדֶם|odem
אוֹדֶם|odem
נֶאְדָּר|ne'edar
אַדִּיר|adir
אָדִישׁ|adish
לֶאֱהוֹב|le'ehov
לְהִתְאַהֵב|lehit'ahev
אַהֲבָה|ahava
אָהוּב|ahuv
מְאוֹהָב|me'ohav
לְהֵיאָהֵב|lehe'ahev
אוֹהֵד|ohed
לֶאֱהוֹד|le'ehod
לֶאֱהוֹהַּ|le'ehoah
אוֹהֶל|ohel
אוֹ|o
אוֹדוֹת|odot
אֲווִיר|avir
לְהָאִיט|leha'it
אוֹטוֹבּוּס|otobus
תַּאֲווָה|ta'ava
לְאַוּוֹת|le'avot
לְהִתְאַוּוֹת|lehit'avot
אוּכְלוּסִיָּה|uchlusiya
אוּלַי|ulay
אוּלְפָּן|ulpan
אוּנִיבֶרְסִיטָה|universita
אוֹפַנּוֹעַ|ofanoa
לָאוּץ|la'utz
לְהָאִיץ|leha'itz
לְהָאִיר|leha'ir
אוֹר|or
תְּאוּרָה|te'ura
מְאוּרָה|me'ura
מָאוֹר|ma'or
לְאַווְרֵר|le'avrer
לְהִתְאַווְרֵר|lehit'avrer
אִיווְרוּר|ivrur
מְאַווְרֵר|me'avrer
לְאַווְשֵׁשׁ|le'avshesh
אִיווְשׁוּשׁ|ivshush
לְהֵיאוֹת|lehe'ot
לְאוֹתֵת|le'otet
אוֹת|ot
אוֹת|ot
אָז|az
לְאַזְכֵּר|le'azker
לֶאֱזוֹל|le'ezol
אִזְמֵל|izmel
לְהַאֲזִין|leha'azin
לְאַזֵּן|le'azen
לְהִתְאַזֵּן|lehit'azen
אוֹזֶן|ozen
הַאֲזָנָה|ha'azana
אִיזּוּן|izun
לֶאֱזוֹק|le'ezok
אֲזִיקִּים|azikim
לְהִתְאַזֵּר|lehit'azer
אֵזוֹר|ezor
לֶאֱזוֹר|le'ezor
אָח|ach
לְאַחֵד|le'ached
לְהִתְאַחֵד|lehit'ached
אַחְדוּת|achdut
אִיחוּד|ichud
הִתְאַחֲדוּת|hit'achadut
אָחִיד|achid
לְהַאֲחִיד|leha'achid
מְאוּחָד|me'uchad
הַאֲחָדָה|ha'achada
אָחוֹת|achot
לֶאֱחוֹז|le'echoz
לְהֵיאָחֵז|lehe'achez
אָחוּז|achuz
לְאַחוֹת|le'achot
לְהִתְאַחוֹת|lehit'achot
אַחְייָן|achyan
אַחְייָנִית|achyanit
לְאַחֵל|le'achel
לְאַחְסֵן|le'achsen
אִיחְסוּן|ichsun
לְאַחֵר|le'acher
אָחוֹר|achor
אַחַר|achar
אָחוֹרָה|achora
מֵאֲחוֹרֵי|me'achorei
אֲחוֹרַייִם|achorayim
אַחֵר|acher
אַחֲרוֹן|acharon
לְהִתְאַחֵר|lehit'acher
אִיטִּי|iti
אַט|at
לְהָאֵט|leha'et
לֶאֱטוֹם|le'etom
לְהֵיאָטֵם|lehe'atem
אִיטּוּם|itum
אִטְרִיָּה|itriya
אִי|i
אוֹיֵב|oyev
אֵיבָה|eiva
אֵיבָר|eivar
לְאַייֵּד|le'ayed
אַיָּה|aya
אֵיזֶה|eize
אֵיזוֹ|eizo
אַייָּל|ayal
אֵיךְ|eich
אֵיכוּת|eichut
אַיִל|ayil
אֱייָל|eyal
אִילּוּ|ilu
אֵילוּ|eilu
אִיּוּם|iyum
לְאַייֵּם|le'ayem
אֵימָה|eima
אָיוֹם|ayom
אֵין|ein
לְאַייֵּן|le'ayen
אֵיפֹה|eifo
אִיּוּר|iyur
לְאַייֵּר|le'ayer
לְאַייֵּשׁ|le'ayesh
אִישׁוֹן|ishon
לְאַייֵּת|le'ayet
אֵיתָן|eitan
אֵיתָנוּת|eitanut
אַךְ|ach
לְאַכְזֵב|le'achzev
לְהִתְאַכְזֵב|lehit'achzev
מְאוּכְזָב|me'uchzav
לְהִתְאַכְזֵר|lehit'achzer
לֶאֱכוֹל|le'echol
לְהֵיאָכֵל|lehe'achel
לְאַכֵּל|le'akel
לְהַאֲכִיל|leha'achil
אוֹכֶל|ochel
אַכְלָן|achlan
אֲכִילָה|achila
אָכוּל|achul
לְאַכְלֵס|le'achles
לְאַכְסֵן|le'achsen
לְהִתְאַכְסֵן|lehit'achsen
לֶאֱכוֹף|le'echof
לְהֵיאָכֵף|lehe'achef
אִכְפַּת|ichpat
אֶל|el
אַל|al
אֵלֶה|ele
אַלָּה|ala
אֵלוּ|elu
אֱלוֹהַּ|eloah
אֱלוֹהִים|elohim
לְאַלְחֵשׁ|le'alchesh
אֱלִיל|elil
אֲלַכְסוֹן|alachson
לְהֵיאָלֵם|lehe'alem
אַלִּים|alim
אִילֵּם|ilem
אַלְמוֹג|almog
אַלְמוֹנִי|almoni
לְהִתְאַלְמֵן|lehit'almen
לְאַלֵּף|le'alef
אֶלֶף|elef
אַלּוּף|aluf
לְהֵיאָלֵץ|lehe'aletz
לְאַלֵּץ|le'aletz
אִילּוּץ|ilutz
לְאַלְתֵּר|le'alter
אֵם|em
אִם|im
אִמָּא|ima
אַמְבַּטְיָה|ambatya
לֶאֱמוֹד|le'emod
לְהֵיאָמֵד|lehe'amed
אָמִיד|amid
אֶמוֹצְיוֹנָלִי|emotzyonali
לְאַמְלֵל|le'amlel
אוֹם|om
לְהֵיאָמֵן|lehe'amen
לְהַאֲמִין|leha'amin
לְהִתְאַמֵּן|lehit'amen
מְאַמֵּן|me'amen
אוּמָּן|uman
אוֹמְנָם|omnam
אִימּוּן|imun
לְאַמֵּן|le'amen
אָמִין|amin
אוֹמָּן|oman
אוֹמָּנוּת|omanut
אֱמוּנָה|emuna
אָמֵן|amen
אוּמָּנוּת|umanut
לְאַמֵּץ|le'ametz
לְהִתְאַמֵּץ|lehit'ametz
לֶאֱמוֹץ|le'emotz
אַמִּיץ|amitz
מַאֲמָץ|ma'amatz
אוֹמֶץ|ometz
אָמוּר|amur
לְהֵיאָמֵר|lehe'amer
לְהַאֲמִיר|leha'amir
אִמְרָה|imra
לוֹמַר|lomar
מַאֲמָר|ma'amar
לְהַאֲמִיר|leha'amir
לְאַמֵּת|le'amet
לְהִתְאַמֵּת|lehit'amet
אֲמִיתִּי|amiti
אֲמִיתָּה|amita
אֱמֵת|emet
אִימּוּת|imut
אֲמִיתּוּת|amitut
אָנוּ|anu
אֲנוֹכִי|anochi
לְהֵיאָנֵחַ|lehe'aneach
לְהִתְאַנֵּחַ|lehit'aneach
אֲנַחְנוּ|anachnu
אַנְטִישֶׁמִי|antishemi
אַנְטִישֶׁמִיּוּת|antishemiyut
אֲנִי|ani
לְאַנּוֹת|le'anot
תְּאוּנָה|te'una
אֳנִייָּה|oniya
אֲנָךְ|anach
אֲנָכִי|anachi
מְאוּנָּךְ|me'unach
לְהִתְאוֹנֵן|lehit'onen
לְאוֹנֵן|le'onen
לֶאֱנוֹס|le'enos
לְהֵיאָנֵס|lehe'anes
לְהֵיאָנֵק|lehe'anek
אִישִׁיּוּת|ishiyut
אִישִׁי|ishi
אִישִׁית|ishit
אִישׁ|ish
אִישָּׁה|isha
אֱנוֹשׁ|enosh
אָסוֹן|ason
אַסְטְרוֹנוֹמְיָה|astronomya
אַסְלָה|asla
לְהִתְאַסְלֵם|lehit'aslem
לְהֵיאָסֵף|lehe'asef
לְהִתְאַסֵּף|lehit'asef
אוֹסֶף|osef
אַסְפָן|asfan
לֶאֱסוֹף|le'esof
לְהֵיאָסֵר|lehe'aser
אִיסּוּר|isur
אָסוּר|asur
אָסִיר|asir
לֶאֱסוֹר|le'esor
לְהֵיאָפוֹת|lehe'afot
לֶאֱפוֹת|le'efot
אֲפִילּוּ|afilu
לְאַפְייֵן|le'afyen
לְהִתְאַפְייֵן|lehit'afyen
אַפִּיפְיוֹר|apifyor
לְהַאֲפִיל|leha'afil
אָפֵל|afel
אֲפֵלָה|afela
אוֹפְנָה|ofna
אוֹפֶן|ofen
אוֹפַןּ|ofan
אוֹפַנַּייִם|ofanayim
לְאַפְנֵן|le'afnen
לֶאֱפוֹס|le'efos
לְאַפֵּס|le'apes
אֶפֶס|efes
לְהִתְאַפֵּס|lehit'apes
אַפְסִי|afsi
לֶאֱפוֹף|le'efof
אַף|af
אוֹפֶק|ofek
לְהִתְאַפֵּק|lehit'apek
לְהַאֲפִיר|leha'afir
לְאַפֵּר|le'aper
לְהִתְאַפֵּר|lehit'aper
אָפוֹר|afor
מַאֲפֵרָה|ma'afera
אֲפַרְסֵק|afarsek
לְהִתְאַפְשֵׁר|lehit'afsher
אֶפְשָׁר|efshar
לְאַפְשֵׁר|le'afsher
אֶפְשָׁרוּת|efsharut
אֶפְשָׁרִי|efshari
אֵצֶל|etzel
לְהַאֲצִיל|leha'atzil
אוֹצָר|otzar
לֶאֱצוֹר|le'etzor
אַקְלִים|aklim
לְהִתְאַקְלֵם|lehit'aklem
אֲרוּבָּה|aruba
לֶאֱרוֹב|le'erov
לֶאֱרוֹג|le'erog
לְהֵיאָרֵג|lehe'areg
לְאַרְגֵּן|le'argen
לְהִתְאַרְגֵּן|lehit'argen
אִירְגּוּן|irgun
אָרוֹן|aron
לֶאֱרוֹז|le'eroz
אֶרֶז|erez
אֲרִיזָה|ariza
לְהֵיאָרֵז|lehe'arez
אוֹרֶז|orez
לְאָרֵחַ|le'areach
לְהִתְאָרֵחַ|lehit'areach
אוֹרֵחַ|oreach
אֲרוּחָה|arucha
אוֹרַח|orach
לֶאֱרוֹת|le'erot
אַרְיֵה|arye
לֶאֱרוֹךְ|le'eroch
לְהַאֲרִיךְ|leha'arich
לְהִתְאָרֵךְ|lehit'arech
אוֹרֶךְ|orech
אַרְכָּה|arka
אָרוֹךְ|aroch
אַרְמוֹן|armon
אוֹרֶן|oren
אַרְנָב|arnav
אַרְנָק|arnak
לְהִתְאָרֵס|lehit'ares
לְאָרֵעַ|le'area
אֵירוּעַ|erua
אֶרֶץ|eretz
אַרְצִי|artzi
לְהַאֲרִיק|leha'arik
הַאֲרָקָה|ha'araka
לְאָרֵר|le'arer
לָאוֹר|la'or
אָרוּר|arur
אֵשׁ|esh
אֶשֶׁךְ|eshech
לְהַאֲשִׁים|leha'ashim
לְהֵיאָשֵׁם|lehe'ashem
אַשְׁמָה|ashma
אָשֵׁם|ashem
לֶאְשׁוֹם|le'eshom
אֶשְׁנָב|eshnav
אַשָּׁף|ashaf
אַשְׁפָּה|ashpa
לְאַשְׁפֵּז|le'ashpez
לְהִתְאַשְׁפֵּז|lehit'ashpez
לְאַשֵּׁר|le'asher
אִישּׁוּר|ishur
אָשׁוּר|ashur
אֲשֶׁר|asher
מְאוּשָּׁר|me'ushar
אוֹשֶׁר|osher
לְהִתְאוֹשֵׁשׁ|lehit'oshesh
לְאוֹשֵׁשׁ|le'oshesh
לְאַשֵּׁשׁ|le'ashesh
הִתְאוֹשְׁשׁוּת|hit'osheshut
לְהִתְאוֹשֵׁשׁ|lehit'oshesh
אֶת|et
אַתְּ|at
לְאַתְגֵּר|le'atger
מְאוּתְגָּר|me'utgar
אַתָּה|ata
לְאַתְחֵל|le'atchel
אִיתְחוּל|itchul
אַתֶּם|atem
אֶתְמוֹל|etmol
אַתֶּן|aten
לְאַתֵּר|le'ater
אִיתּוּר|itur
אֲתָר|atar
אֶתְרוֹג|etrog
אַתָּת|atat
בְּ־|be
בְּאֶמְצָעוּת|be'emtza'ut
מְבוּאָס|mevu'as
לְבַאֵס|leva'es
לְהִתְבָּאֵס|lehitba'es
לְבָאֵר|leva'er
לְהִתְבָּאֵר|lehitba'er
בְּאֵר|be'er
בְּבַקָּשָׁה|bevakasha
בֶּגֶד|beged
לְהִיבָּגֵד|lehibaged
לִבְגּוֹד|livgod
בְּגִין|begin
בִּגְלַל|biglal
הִתְבַּגְּרוּת|hitbagrut
בַּגְרוּת|bagrut
מְבוּגָּר|mevugar
לְהִתְבַּגֵּר|lehitbager
לִבְגּוֹר|livgor
בִּגְרוּשׁ|bigrush
בַּד|bad
לִבְדּוֹא|livdo
לְבוֹדֵד|levoded
לְהִתְבּוֹדֵד|lehitboded
בַּד|bad
לְבַדֵּד|levaded
לְבַד|levad
בִּידּוּד|bidud
בֶּדוּאִי|bedu'i
לְבַדֵּחַ|levadeach
לְהִתְבַּדֵּחַ|lehitbadeach
בְּדִיחָה|bdicha
לִבְדּוֹת|livdot
לְהִיבָּדוֹת|lehibadot
בִּדְיוֹן|bidyon
בָּדוּי|baduy
בִּדְיוֹנִי|bidyoni
לְבַדּוֹת|levadot
לְהִיבָּדֵל|lehibadel
לְהַבְדִּיל|lehavdil
לְבַדֵּל|levadel
הֶבְדֵּל|hevdel
הַבְדָּלָה|havdala
לְהִתְבַּדֵּל|lehitbadel
לִבְדּוֹק|livdok
לְהִיבָּדֵק|lehibadek
מִבְדָּק|mivdak
בְּדִיקָה|bdika
מִבְדּוֹק|mivdok
לְבַדֵּר|levader
לְהִתְבַּדֵּר|lehitbader
בִּידּוּר|bidur
לִבְהוֹת|livhot
לְהִיבָּהֵל|lehibahel
לְהַבְהִיל|lehavhil
מְבוֹהָל|mevohal
תַּבְהֵלָה|tavhela
לְהַבְהִיל|lehavhil
בְּהֵמָה|behema
לִבְהוֹק|livhok
לְהַבְהִיק|lehavhik
לְהִתְבַּהֵר|lehitbaher
לְהַבְהִיר|lehavhir
בָּהִיר|bahir
לָבוֹא|lavo
לְהָבִיא|lehavi
מָבוֹא|mavo
בְּווַדַּאי|bevaday
לָבוּז|lavuz
לְהָבִיךְ|lehavich
מָבוֹךְ|mavoch
מְבוּכָה|mevucha
לְהִיבּוֹךְ|lehiboch
בּוּל|bul
לְהִתְבּוֹסֵס|lehitboses
לְהָבִיס|lehavis
בּוּעָה|bu'a
בּוֹר|bor
בּוֹר|bor
בּוּרְסָה|bursa
לְבוֹשֵׁשׁ|levoshesh
לֵבוֹשׁ|levosh
לְבַזְבֵּז|levazbez
לְהִתְבַּזְבֵּז|lehitbazbez
בִּיזְבּוּז|bizbuz
לִבְזוֹז|livzoz
בַּז|baz
לְבַזּוֹת|levazot
לְהִתְבַּזּוֹת|lehitbazot
בִּזְכוּת|bizchut
לִבְזוֹק|livzok
לְהַבְזִיק|lehavzik
לְבַזֵּר|levazer
בָּחוּץ|bachutz
לִבְחוֹל|livchol
לְהַבְחִיל|lehavchil
לִבְחוֹן|livchon
לְהַבְחִין|lehavchin
לְהִיבָּחֵן|lehibachen
בּוֹחַן|bochan
מַבְחֵנָה|mavchena
בְּחִינָה|bchina
מִבְחָן|mivchan
אַבְחָנָה|avchana
הַבְחָנָה|havchana
לִבְחוֹר|livchor
לְהִיבָּחֵר|lehibacher
בְּחִירָה|bchira
בָּחוּר|bachur
בַּחוּרָה|bachura
לִבְחוֹשׁ|livchosh
לְהִתְבַּטֵּא|lehitbate
מִבְטָא|mivta
לְבַטֵּא|levate
בִּיטָּאוֹן|bita'on
לִבְטוֹחַ|livtoach
לְבַטֵּחַ|levateach
לְהַבְטִיחַ|lehavtiach
בֶּטַח|betach
אַבְטָחָה|avtacha
בִּיטָּחוֹן|bitachon
בִּיטּוּחַ|bituach
בָּטוּחַ|batuach
מוּבְטָח|muvtach
הַבְטָחָה|havtacha
בִּיטּוּי|bituy
לְבַטֵּל|levatel
לְהִתְבַּטֵּל|lehitbatel
מוּבְטָל|muvtal
אַבְטָלָה|avtala
בִּיטּוּל|bitul
בַּטְלָן|batlan
לִבְטוֹל|livtol
לְהִתְבַּטֵּל|lehitbatel
בֵּטֶן|beten
בִּיטּוּן|bitun
בּוֹטֶן|boten
בִּטְנָה|bitna
בִּיּוּב|biyuv
בְּיַחַד|beyachad
לְבַייֵּל|levayel
לְבַייֵּם|levayem
לְהָבִין|lehavin
הִתְבּוֹנְנוּת|hitbonenut
תּוֹבָנָה|tovana
לְבוֹנֵן|levonen
בֵּין|ben
בִּיּוּן|biyun
לְבַייֵּן|levayen
מוּבָן|muvan
לְהִתְבּוֹנֵן|lehitbonen
הֲבָנָה|havana
נָבוֹן|navon
בִּינָה|bina
בֵּינוֹנִי|benoni
בֵּינוֹנִי|benoni
בֵּינְתַייִם|bentayim
בֵּיצָה|beitza
בִּירָה|bira
לְהִתְבַּייֵּשׁ|lehitbayesh
בַּייְשָׁן|bayshan
לְבַייֵּשׁ|levayesh
בַּיִת|bayit
לְבַייֵּת|levayet
בֵּית כְּנֶסֶת|beitkneset
בֵּית סֵפֶר|beitsefer
לִבְכּוֹת|livkot
לְבַכּוֹת|levakot
בַּכְייָן|bachyan
לְהִתְבַּכְייֵן|lehitbachyen
בְּכוֹר|bchor
לְהַבְכִּיר|lehavkir
בָּכִיר|bachir
בִּלְבַד|bilvad
לְבַלְבֵּל|levalbel
לְהִתְבַּלְבֵּל|lehitbalbel
בִּילְבּוּל|bilbul
לְהַבְלִיג|lehavlig
בָּלָגָן|balagan
לְבַלְגֵּן|levalgen
לְהַבְלִיחַ|lehavliach
לִבְלוֹט|livlot
לְהַבְלִיט|lehavlit
לְהִתְבַּלֵּט|lehitbalet
בַּלּוּט|balut
בְּלִיטָה|blita
בָּלָטָה|balata
לְהִתְבַּלּוֹת|lehitbalot
לִבְלוֹת|livlot
בְּלִי|bli
לְבַלּוֹת|levalot
בִּילּוּי|biluy
לְהִתְבּוֹלֵל|lehitbolel
לִבְלוֹל|livlol
לְהִיבָּלֵם|lehibalem
בְּלִימָה|blima
בַּלָּם|balam
בֶּלֶם|belem
לִבְלוֹם|livlom
לִבְלוֹעַ|livloa
לְהִיבָּלֵעַ|lehibalea
לְבַּלֵף|lebalef
בַּלֶּשֶׁת|baleshet
בַּלָּשׁ|balash
בִּילּוּשׁ|bilush
לִבְלוֹשׁ|livlosh
בִּמְהִירוּת|bimhirut
בַּמַּאי|bamay
בִּמְיוּחָד|bimyuchad
בְּמַעֲמַד|bema'amad
בִּמְקוֹם|bimkom
בֵּן|ben
לִבְנוֹת|livnot
לְהִיבָּנוֹת|lehibanot
בַּנַּאי|banay
בִּינּוּי|binuy
מוּבְנֶה|muvne
תַּבְנִית|tavnit
לְהַבְנוֹת|lehavnot
בִּנְייָן|binyan
בְּנִייָּה|bniya
בָּנוּי|banuy
בָּנָנָה|banana
בַּנְק|bank
לְבַסֵּס|levases
לְהִתְבַּסֵּס|lehitbases
בְּסִיסָה|bsisa
מְבוּסָּס|mevusas
בָּסִיס|basis
לְבַעְבֵּעַ|leva'abea
לִבְעוֹט|liv'ot
לְהִיבָּעֵט|lehiba'et
לְהִיבָּעוֹת|lehiba'ot
בְּעָיָה|be'aya
בַּעַל|ba'al
לִבְעוֹל|liv'ol
בְּעִקְבוֹת|be'ikvot
לִבְעוֹר|liv'or
לְהַבְעִיר|lehav'ir
מַבְעֵר|mav'er
לְבַעֵר|leva'er
תַּבְעֵרָה|tav'era
בַּעַת|ba'at
לְהִיבָּעֵת|lehiba'et
בִּפְנֵי|bifnei
בִּפְנִים|bifnim
לְבַצְבֵּץ|levatzbetz
לְבַצֵּעַ|levatzea
לְהִתְבַּצֵּעַ|lehitbatzea
בִּיצּוּעַ|bitzua
מִבְצָע|mivtza
לִבְצוֹעַ|livtzoa
בִּיצָּה|bitza
בּוֹץ|botz
בָּצֵק|batzek
בָּצֵק|batzek
לְבַצֵּר|levatzer
לְהִתְבַּצֵּר|lehitbatzer
לְהִיבָּצֵר|lehibatzer
לִבְצוֹר|livtzor
בָּקִיא|baki
בַּקְבּוּק|bakbuk
בִּקְבִיעוּת|bikvi'ut
בְּקַלּוּת|bekalut
לִבְקוֹעַ|livkoa
לְבַקֵּעַ|levakea
לְהִיבָּקֵעַ|lehibakea
לְהִתְבַּקֵּעַ|lehitbakea
לְהַבְקִיעַ|lehavkia
לְבַקֵּר|levaker
בּוֹקֶר|boker
בַּקָּרָה|bakara
בִּיקּוּר|bikur
בִּיקּוֹרֶת|bikoret
בְּקֶרֶב|bekerev
לְבַקֵּשׁ|levakesh
לְהִתְבַּקֵּשׁ|lehitbakesh
בִּיקּוּשׁ|bikush
בַּקָּשָׁה|bakasha
לִבְרוֹא|livro
לְהִיבָּרֵא|lehibare
לְהַבְרִיא|lehavri
הַבְרָאָה|havra'a
בָּרִיא|bari
לְבָרֵא|levare
בְּרִיאוּת|bri'ut
תַּבְרוּאָה|tavru'a
לְבַרְבֵּר|levarber
לְהִתְבַּרְבֵּר|lehitbarber
לְהַבְרִיג|lehavrig
בּוֹרֶג|boreg
מַבְרֵג|mavreg
לְהִתְבָּרֵג|lehitbareg
בָּרָד|barad
בַּרְווָז|barvaz
לְהַבְרִיז|lehavriz
בֶּרֶז|berez
בַּרְזֶל|barzel
לִבְרוֹחַ|livroach
לְהַבְרִיחַ|lehavriach
בְּרִית|brit
בְּרֵיכָה|brecha
לְהִתְבַּרְייֵן|lehitbaryen
לְבָרֵךְ|levarech
לְהִתְבָּרֵךְ|lehitbarech
בְּרָכָה|bracha
בָּרוּךְ|baruch
בֶּרֶךְ|berech
לְהַבְרִיק|lehavrik
הַבְרָקָה|havraka
בָּרָק|barak
מִבְרָק|mivrak
לִבְרוֹק|livrok
בָּרֶקֶת|bareket
בָּרוּר|barur
לְבָרֵר|levarer
לְהִתְבָּרֵר|lehitbarer
בְּרֵירָה|brera
לָבוֹר|lavor
בַּרְרָן|bareran
מוּבְרָר|muvrar
לְהַבְרִישׁ|lehavrish
בִּשְׁבִיל|bishvil
לִבְשׁוֹל|livshol
לְבַשֵּׁל|levashel
לְהַבְשִׁיל|lehavshil
לְהִתְבַּשֵּׁל|lehitbashel
בִּישּׁוּל|bishul
בָּשֵׁל|bashel
לְבַשֵּׂם|levasem
לְהִתְבַּשֵּׂם|lehitbasem
בּוֹשֶׂם|bosem
בְּשֵׁם|beshem
לְבַשֵּׂר|levaser
בָּשָׂר|basar
בְּשָׂרִי|bsari
לְהִתְבַּשֵּׂר|lehitbaser
בַּת|bat
בְּתוֹךְ|betoch
לְבַתֵּק|levatek
לְבַתֵּר|levater
גַּאֲווָה|ga'ava
לִגְאוֹת|lig'ot
לְהִתְגָּאוֹת|lehitga'ot
גֵּאֶה|ge'e
גָּאוֹן|ga'on
לִגְאוֹל|lig'ol
לְהִיגָּאֵל|lehiga'el
גְּאוּלָּה|ge'ula
לְגַבֵּב|legabev
גַּב|gav
גַּבָּה|gaba
לִגְבּוֹהַּ|ligboah
לְהַגְבִּיהַּ|lehagbiah
גּוֹבַהּ|govah
גָּבוֹהַּ|gavoah
לִגְבּוֹת|ligbot
לְגַבּוֹת|legabot
לְהִיגָּבוֹת|lehigavot
גִּיבּוּי|gibuy
לְהַגְבִּיל|lehagbil
הַגְבָּלָה|hagbala
גְּבוּל|gvul
לִגְבּוֹל|ligbol
גְּבִינָה|gvina
גַּבָּן|gaban
גֶּבֶס|geves
לְגַבֵּס|legabes
גִּבְעָה|giv'a
גֶּבַע|geva
לִגְבּוֹר|ligbor
לְהַגְבִּיר|lehagbir
גִּיבּוֹר|gibor
הִתְגַּבְּרוּת|hitgabrut
גֶּבֶר|gever
גְּבַרְתָּן|gvartan
גְּבוּרָה|gvura
לְהִתְגַּבֵּר|lehitgaber
לְגַבֵּשׁ|legabesh
לְהִתְגַּבֵּשׁ|lehitgabesh
גִּיבּוּשׁ|gibush
לְגַגֵּל|legagel
לְהִתְגּוֹדֵד|lehitgoded
לִגְדּוֹד|ligdod
גְּדִי|gdi
לְהַגְדִּיל|lehagdil
לִגְדּוֹל|ligdol
לְגַדֵּל|legadel
גְּדִילָה|gdila
מִגְדָּל|migdal
הַגְדָּלָה|hagdala
גּוֹדֶל|godel
מַגְדֶּלֶת|magdelet
גָּדוֹל|gadol
אֲגוּדָל|agudal
גִּידּוּל|gidul
לִגְדּוֹם|ligdom
לְהִיגָּדֵם|lehigadem
לִגְדּוֹעַ|ligdoa
לְגַדֵּף|legadef
גִּידּוּף|giduf
לְגַדֵּר|legader
לְהַגְדִּיר|lehagdir
מִגְדָּר|migdar
הַגְדָּרָה|hagdara
גָּדֵר|gader
לִגְדּוֹר|ligdor
לְהִתְגַּדֵּר|lehitgader
לְהַגְדִּישׁ|lehagdish
לִגְדּוֹשׁ|ligdosh
לְגַהֵץ|legahetz
מַגְהֵץ|maghetz
לְגַהֵק|legahek
לִגְהוֹר|lighor
גֵּו|gev
לְהָגִיב|lehagiv
תְּגוּבָה|tguva
מוּגָז|mugaz
לְהִיגּוֹז|lehigoz
לְגַווֵּן|legaven
גָּווֶן|gaven
לִגְווֹעַ|ligvoa
גּוּף|guf
לְהָגִיף|lehagif
גּוּפָה|gufa
לָגוּר|lagur
לְהִתְגּוֹרֵר|lehitgorer
לִגְזוֹז|ligzoz
לְהִיגָּזֵז|lehigazez
לִגְזוֹל|ligzol
לְהִיגָּזֵל|lehigazel
לִגְזוֹם|ligzom
לְהִיגָּזֵם|lehigazem
לְהַגְזִים|lehagzim
הַגְזָמָה|hagzama
גִּזְעִי|giz'i
גֶּזַע|geza
גִּזְעָן|giz'an
גִּזְעָנוּת|giz'anut
לְהִיגָּזֵר|lehigazer
נִגְזָר|nigzar
גָּזִיר|gazir
גִּזְרָה|gizra
גֶּזֶר|gezer
גִּיזָּרוֹן|gizaron
לִגְזוֹר|ligzor
לִגְחוֹךְ|ligchoch
לְגַחֵךְ|legachech
לְהַגְחִיךְ|lehagchich
מְגוּחָךְ|meguchach
לִגְחוֹן|ligchon
גֵּיאוֹמֶטְרְיָה|ge'ometrya
לְהָגִיחַ|lehagiach
גִּיחָה|gicha
לָגִיחַ|lagiach
לָגִיל|lagil
גִּיל|gil
לְגַייֵּס|legayes
לְהִתְגַּייֵּס|lehitgayes
גִּיּוּס|giyus
לְגַייֵּר|legayer
לְהִתְגַּייֵּר|lehitgayer
גִּיּוּר|giyur
לְגַלְגֵּל|legalgel
לְהִתְגַּלְגֵּל|lehitgalgel
גַּלְגָּל|galgal
גּוּלְגּוֹלֶת|gulgolet
גַּלְגָּלוֹן|galgalon
גַּלְגִּילּוֹן|galgilon
גִּילְגּוּל|gilgul
לְהַגְלִיד|lehaglid
גְּלִידָה|glida
מְגוּלְווָן|megulvan
לְגַלֵּחַ|legaleach
לְהִתְגַּלֵּחַ|lehitgaleach
גִּילּוּחַ|giluach
לְגַלּוֹת|legalot
לִגְלוֹת|liglot
לְהִיגָּלוֹת|lehigalot
לְהַגְלוֹת|lehaglot
גְּלוּיָה|gluya
תַּגְלִית|taglit
גָּלוּת|galut
גָּלוּי|galuy
גִּילּוּי|giluy
לְהִתְגַּלּוֹת|lehitgalot
גִּילָּיוֹן|gilayon
לְגוֹלֵל|legolel
לְהִתְגּוֹלֵל|lehitgolel
גַּל|gal
גְּלוּלָה|glula
מְגִילָּה|megila
לִגְלוֹל|liglol
לְהִיגּוֹל|lehigol
גְּלִילָה|glila
לְגַלֵּם|legalem
לְהִתְגַּלֵּם|lehitgalem
לְהִתְגַּלֵּעַ|lehitgalea
לְגַלֵּף|legalef
תַּגְלִיף|taglif
גְּלוּפָה|glufa
לִגְלוֹשׁ|liglosh
לְהִתְגַּלֵּשׁ|lehitgalesh
מַגְלֵשָׁה|maglesha
גַּם|gam
לִגְמוֹא|ligmo
גּוֹמֶא|gome
לְגַמְגֵּם|legamgem
לְגַמֵּד|legamed
לְהִתְגַּמֵּד|lehitgamed
לְהִיגָּמֵל|lehigamel
גָּמָל|gamal
גַּמָּל|gamal
תַּגְמוּל|tagmul
לִגְמוֹל|ligmol
גִּמְלָה|gimla
גִּמְלָה|gimla
לִגְמוֹר|ligmor
לְהִיגָּמֵר|lehigamer
לְהַגְמִישׁ|lehagmish
גָּמִישׁ|gamish
לִגְנוֹב|lignov
לְהִיגָּנֵב|lehiganev
לְהַגְנִיב|lehagniv
גְּנֵיבָה|gneva
לְהִתְגַּנֵּב|lehitganev
גָּנוּב|ganuv
לְגַנְדֵּר|legander
לְהִתְגַּנְדֵּר|lehitgander
לְהִיגָּנֵז|lehiganez
לִגְנוֹז|lignoz
לִגְנוֹחַ|lignoach
לְגַנּוֹת|leganot
לְגוֹנֵן|legonen
לְהִתְגּוֹנֵן|lehitgonen
לְהָגֵן|lehagen
גַּן|gan
גַּנָּן|ganan
לָגוֹן|lagon
מָגֵן|magen
לְגַנֵּן|leganen
לִגְסוֹס|ligsos
גַּס|gas
לְגַעְגֵּעַ|lega'agea
לְהִתְגַּעְגֵּעַ|lehitga'agea
גִּיעְגּוּעַ|gi'agua
גַּעְגּוּעִים|ga'agu'im
לִגְעוֹת|lig'ot
לְהַגְעִיל|lehag'il
לִגְעוֹל|lig'ol
לִגְעוֹר|lig'or
גְּעָרָה|ge'ara
לִגְעוֹשׁ|lig'osh
גֶּפֶן|gefen
לְגַפֵּף|legapef
לִגְרוֹב|ligrov
גֶּרֶב|gerev
לְגַרְגֵּר|legarger
לְגָרֵד|legared
לְהִתְגָּרֵד|lehitgared
גָּרוֹן|garon
גְּרוּשׁ|grush
גַּרְזֶן|garzen
לְגָרוֹת|legarot
לְהִתְגָּרוֹת|lehitgarot
אֶתְגָר|etgar
לְהַגְרִיל|lehagril
הַגְרָלָה|hagrala
גּוֹרָל|goral
לְהִיגָּרֵם|lehigarem
לִגְרוֹם|ligrom
לְהִיגָּרֵס|lehigares
גִּירְסָה|girsa
לִגְרוֹס|ligros
לִגְרוֹעַ|ligroa
לְהִיגָּרֵעַ|lehigarea
גָּרוּעַ|garua
גֵּירָעוֹן|gera'on
לִגְרוֹף|ligrof
לְהִיגָּרֵף|lehigaref
אֶגְרוֹף|egrof
מַגְרֵפָה|magrefa
לְהִיגָּרֵר|lehigarer
לְגָרֵר|legarer
גְּרָר|grar
לִגְרוֹר|ligror
לְגָרֵשׁ|legaresh
לְהִתְגָּרֵשׁ|lehitgaresh
גָּרוּשׁ|garush
גֶּרֶשׁ|geresh
מִגְרָשׁ|migrash
לְהַגְשִׁים|lehagshim
לְהִתְגַּשֵּׁם|lehitgashem
גֶּשֶׁם|geshem
הִתְגַּשְּׁמוּת|hitgashmut
גָּשׁוּם|gashum
לְגַשֵּׁר|legasher
גֶּשֶׁר|gesher
לִגְשׁוֹר|ligshor
לְגַשֵּׁשׁ|legashesh
לְהִתְגּוֹשֵׁשׁ|lehitgoshesh
לִדְאוֹב|lid'ov
לִדְאוֹג|lid'og
לְהַדְאִיג|lehad'ig
דְּאָגָה|de'aga
לִדְאוֹת|lid'ot
דָּאוֹן|da'on
דּוֹאַר|do'ar
לְדוֹבֵב|ledovev
דּוֹב|dov
לְדַבֵּב|ledabev
לִדְבּוֹב|lidbov
דְּבוֹרָה|dvora
לְדַבְלֵל|ledavlel
לִדְבּוֹק|lidbok
לְהִידָּבֵק|lehidavek
מַדְבֵּקָה|madbeka
לְהַדְבִּיק|lehadbik
מִידַּבֵּק|midabek
דֶּבֶק|devek
דָּבִיק|davik
דְּבִיקוּת|dvikut
הִידָּבְקוּת|hidavkut
דִּיבּוּר|dibur
לְדַבֵּר|ledaber
לְהַדְבִּיר|lehadbir
מִדְבָּר|midbar
לְהִידָּבֵר|lehidaver
דָּבָר|davar
לְהִידַּבֵּר|lehidaber
דְּבִיר|dvir
הִידָּבְרוּת|hidavrut
דּוֹבֵר|dover
דּוֹבֶרֶת|doveret
מְדַבֵּר|medaber
הַדְבָּרָה|hadbara
מַדְבִּיר|madbir
דְּבַשׁ|dvash
לְדַגְדֵּג|ledagdeg
לִדְגּוֹל|lidgol
דֶּגֶל|degel
לְהַדְגִּים|lehadgim
דֶּגֶם|degem
דּוּגְמָן|dugman
דּוּגְמָנִית|dugmanit
דּוּגְמָנוּת|dugmanut
דּוּגְמָה|dugma
הַדְגָּמָה|hadgama
דְּגִימָה|dgima
לִדְגּוֹר|lidgor
לְהַדְגִּישׁ|lehadgish
לִדְהוֹת|lidhot
לְהִידָּהֵם|lehidahem
לְהַדְהִים|lehadhim
מַדְהִים|madhim
לִדְהוֹר|lidhor
דּוּבְדְּבָן|duvdevan
לָדוּג|ladug
דָּג|dag
דּוֹד|dod
דּוּדּ|dud
דּוֹדָה|doda
דַּווְקָא|davka
לְדַווֵּחַ|ledaveach
מֵדִיחַ|mediach
לְהָדִיחַ|lehadiach
הֲדָחָה|hadacha
דָּווֶה|dave
לִדְווֹת|lidvot
דּוּכָן|duchan
דּוֹלְפִין|dolfin
לָדוּן|ladun
לְהִידּוֹן|lehidon
דַּווָּר|davar
דּוֹר|dor
דִּירָה|dira
לָדוּר|ladur
לָדוּשׁ|ladush
דִּיוּוּשׁ|divush
דַּווְשָׁה|davsha
לְדַווֵּשׁ|ledavesh
לְהִידָּחוֹת|lehidachot
לִדְחוֹת|lidchot
דָּחוּי|dachuy
דִּיחוּי|dichuy
דְּחִייָּה|dchiya
לִדְחוֹס|lidchos
מַדְחֵס|madches
לִדְחוֹף|lidchof
לְהִידָּחֵף|lehidachef
לִדְחוֹק|lidchok
לְהִידָּחֵק|lehidachek
דַּחַק|dachak
דּוֹחַק|dochak
דְּחִיקָה|dchika
דָּחוּק|dachuk
לְהַדְחִיק|lehadchik
הַדְחָקָה|hadchaka
הֶדְחֵק|hedchek
דַּייָּג|dayag
דְּיוֹקָן|dyokan
דַּיי|day
דַּייְסָה|daysa
דַּייָּל|dayal
דִּיּוּן|diyun
דַּייָּן|dayan
דִּין|din
מְדִינָה|medina
לְהִידַּייֵּן|lehidayen
מְדִינִי|medini
לְדַייֵּק|ledayek
דִּיּוּק|diyuk
מְדוּיָּק|meduyak
דַּייָּר|dayar
לְדַכֵּא|ledake
דִּיכָּאוֹן|dika'on
לִדְלוֹג|lidlog
לְדַלֵּג|ledaleg
מְדוּלְדָּל|meduldal
לְדַלְדֵּל|ledaldel
לְהִידַּלְדֵּל|lehidaldel
לִדְלוֹת|lidlot
לְדַלּוֹת|ledalot
לְדַלֵּל|ledalel
דַּל|dal
דַּלּוּת|dalut
דַּל|dal
דָּלִיל|dalil
לְהַדְלִיף|lehadlif
לִדְלוֹף|lidlof
דְּלִיפָה|dlifa
לְהִידָּלֵק|lehidalek
לְהַדְלִיק|lehadlik
דֶּלֶק|delek
דַּלֶּקֶת|daleket
דָּלוּק|daluk
הַדְלָקָה|hadlaka
לִדְלוֹק|lidlok
דְּלֵקָה|dleka
דָּלִיק|dalik
דְּלִיקוּת|dlikut
דֶּלֶת|delet
לְדַמְדֵּם|ledamdem
דֶּמוֹקְרַטְיָה|demokratya
לִדְמוֹת|lidmot
לְהִידָּמוֹת|lehidamot
לְדַמּוֹת|ledamot
דִּמְיוֹן|dimyon
דְּמוּת|dmut
תַּדְמִית|tadmit
לְהַדְמוֹת|lehadmot
הַדְמָיָה|hadmaya
לְהִידַּמּוֹת|lehidamot
לְדַמְייֵן|ledamyen
לְהִידּוֹם|lehidom
לְדַמֵּם|ledamem
לָדוֹם|ladom
דָּם|dam
לִדְמוֹעַ|lidmoa
דִּמְעָה|dim'a
לְדַסְקֵס|ledaskes
לִדְעוֹךְ|lid'och
לְדַפְדֵּף|ledafdef
דַּפְדֶּפֶת|dafdefet
דַּפְדְּפָן|dafdefan
דּוֹפֶן|dofen
לְהַדְפִּיס|lehadpis
דְּפוּס|dfus
מַדְפֶּסֶת|madpeset
תַּדְפִּיס|tadpis
לְהִידָּפֵס|lehidafes
דַּף|daf
לְהִידָּפֵק|lehidafek
לִדְפּוֹק|lidpok
לְהִתְדַּפֵּק|lehitdapek
לְדַקְדֵּק|ledakdek
דִּיקְדּוּק|dikduk
דֶּקֶל|dekel
לְדַקְלֵם|ledaklem
דַּקָּה|daka
דַּק|dak
לִדְקוֹר|lidkor
לְהִידָּקֵר|lehidaker
לְדַרְבֵּן|ledarben
לְדָרֵג|ledareg
מַדְרֵגָה|madrega
הַדְרָגָה|hadraga
דַּרְגָּה|darga
דֶּרֶג|dereg
לְדַרְדֵּר|ledarder
לְהִידַּרְדֵּר|lehidarder
לְהִידָּרֵךְ|lehidarech
לְהַדְרִיךְ|lehadrich
תַּדְרִיךְ|tadrich
דֶּרֶךְ|derech
הַדְרָכָה|hadracha
מִדְרָכָה|midracha
דַּרְכּוֹן|darkon
לִדְרוֹךְ|lidroch
לְהִידָּרֵךְ|lehidarech
לְהַדְרִים|lehadrim
דָּרוֹם|darom
דָּרוֹמָה|daroma
דְּרוֹמִי|dromi
לְהִידָּרֵס|lehidares
דּוֹרֵס|dores
לִדְרוֹס|lidros
לְהִידָּרֵשׁ|lehidaresh
דְּרִישָׁה|drisha
דָּרוּשׁ|darush
מִדְרָשׁ|midrash
מִדְרָשָׁה|midrasha
לִדְרוֹשׁ|lidrosh
דֶּשֶׁא|deshe
מִדְשָׁאָה|midsha'a
לְדַשְׁדֵּשׁ|ledashdesh
דּוֹשֶׁן|doshen
דֶּשֶׁן|deshen
דִּישּׁוּן|dishun
לְדַשֵּׁן|ledashen
דָּת|dat
דָּתִי|dati
לְהַבְהֵב|lehavhev
לְהַהְבִּיל|lehahbil
הֶבֶל|hevel
לַהֲגוֹת|lahagot
לְהֵיהָגוֹת|lehehagot
הִיגָּיוֹן|higayon
לְהַגֵּר|lehager
הֲגִירָה|hagira
לְהַדְהֵד|lehadhed
הֲדַס|hadas
לַהֲדוֹף|lahadof
לְהַדֵּק|lehadek
הֶדֶק|hedek
לְהִתְהַדֵּק|lehithadek
נֶהֱדָר|nehedar
מַהֲדוּרָה|mahadura
מְהוּדָּר|mehudar
לְהַדֵּר|lehader
לַהֲדוֹר|lahador
הוּא|hu
לְהַוּוֹת|lehavot
לְהִתְהַוּוֹת|lehithavot
הִתְהַוּוּת|hithavut
מְהוּמָה|mehuma
הוֹן|hon
לְהַווֵּן|lehaven
לַהֲזוֹת|lahazot
הָזוּי|hazuy
הִיא|hi
הַיּוֹם|hayom
לִהְיוֹת|lihyot
נִהְיָה|nihya
הֵיכָל|hechal
הֵיכָן|hechan
הִינֵּה|hine
הִיסְטוֹרְיָה|historya
הָכָא|hacha
הֲכִי|hachi
הַלְווַאי|halevay
לָלֶכֶת|lalechet
לְהַלֵּךְ|lehalech
לְהִתְהַלֵּךְ|lehithalech
מַהֲלָךְ|mahalach
הֲלִיךְ|halich
הֲלִיכָה|halicha
תַּהֲלִיךְ|tahalich
לְהַלֵּל|lehalel
לְהִתְהַלֵּל|lehithalel
תְּהִילּוֹת|tehilot
תְּהִילָּה|tehila
לְהָהֵל|lehahel
לַהֲלוֹם|lahalom
לַהֲלוֹם|lahalom
הֵם|hem
לְהַמְהֵם|lehamhem
לְהַמּוֹת|lehamot
לַהֲמוֹת|lahamot
לָהוֹם|lahom
לְהַמֵּם|lehamem
מְהַמֵּם|mehamem
לְהַמֵּר|lehamer
הִימּוּר|himur
הֵן|hen
הֲנָאָה|hana'a
מְהַנְדֵּס|mehandes
הַנְדָּסָה|handasa
לְהַנְדֵּס|lehandes
לְהַנְהֵן|lehanhen
לֵיהָנוֹת|lehanot
לְהַסּוֹת|lehasot
לְהַסֵּס|lehases
לְהִתְהַפֵּךְ|lehithapech
לַהֲפוֹךְ|lahafoch
לְהֵיהָפֵךְ|lehehafech
הֲפַכְפַּךְ|hafachpach
הִיפּוּךְ|hipuch
מַהְפֵּכָה|mahpecha
הִתְהַפְּכוּת|hithapchut
הֶפֶךְ|hefech
לְהַפְּנֵט|lehapnet
לַהֲרוֹג|laharog
לְהֵיהָרֵג|lehehareg
לְהַרְהֵר|leharher
הִירְהוּר|hirhur
לַהֲרוֹת|laharot
הֵירָיוֹן|herayon
הוֹרֶה|hore
הֲרֵי|harei
לְהֵיהָרֵס|lehehares
לַהֲרוֹס|laharos
הֶרֶס|heres
הֶרֶף|heref
הַרְפַּתְקָה|harpatka
הָר|har
לְהַתֵּל|lehatel
וְ־|ve
וַדָאִי|vada'i
לְווַדֵּא|levade
לְהִתְווַדּוֹת|lehitvadot
וִידּוּי|viduy
לְהִתְווַדֵּעַ|lehitvadea
וִילוֹן|vilon
וִיכּוּחַ|vikuach
לְהִתְווַכֵּחַ|lehitvakeach
תּוֹכֵחָה|tochecha
לְהוֹלִיךְ|leholich
מוֹלִיךְ|molich
לְווַסֵּת|levaset
וַעַד|va'ad
וְעִידָה|ve'ida
לְהַווְרִיד|lehavrid
וֶרֶד|vered
וְרִיד|vrid
וָרוֹד|varod
וֶתֶק|vetek
וָתִיק|vatik
וִיתּוּר|vitur
לְווַתֵּר|levater
נוֹתָר|notar
זְאֵב|ze'ev
זֹאת|zot
זְבוּב|zvuv
לִזְבּוֹחַ|lizboach
לְזַבֵּחַ|lezabeach
לְהִיזָּבֵחַ|lehizaveach
זֶבַח|zevach
מִזְבֵּחַ|mizbeach
זֶבֶל|zevel
מִזְבָּלָה|mizbala
לְזַבֵּל|lezabel
זַגָּג|zagag
זִיגּוּג|zigug
לְזַגְזֵג|lezagzeg
זֶה|ze
לְהַזְהִיב|lehazhiv
זָהָב|zahav
לְזַהוֹת|lezahot
לְהִזְדַּהוֹת|lehizdahot
זִיהוּי|zihuy
זֵהֶה|zehe
זֶהוּת|zehut
לְזַהֵם|lezahem
לְהִזְדַּהֵם|lehizdahem
זִיהוּם|zihum
אַזְהָרָה|azhara
לִזְהוֹר|lizhor
לְהַזְהִיר|lehazhir
לְהִיזָּהֵר|lehizaher
הַזְהָרָה|hazhara
זָהִיר|zahir
זְהִירוּת|zehirut
זוּ|zu
לָזוּב|lazuv
לְזַווֵּג|lezaveg
לְהִזְדַּווֵּג|lehizdaveg
לְזַווֵּד|lezaved
מִזְווָדָה|mizvada
מִזְווָד|mizvad
לָזוּד|lazud
לָזוּז|lazuz
לְהָזִיז|lehaziz
תְּזוּזָה|tzuza
הֲזָזָה|hazaza
זָווִית|zavit
זוֹל|zol
לְהָזִין|lehazin
לְהִיזּוֹן|lehizon
מָזוֹן|mazon
לָזוּן|lazun
מִזְנוֹן|miznon
לְהָזִיעַ|lehazia
זְווָעָתִי|zva'ati
לָזוּעַ|lazua
זְווָעָה|zva'a
זָר|zar
לְהִיזּוֹר|lehizor
מוּזָר|muzar
זָחִיחַ|zachiach
לְהִזְדַּחֵל|lehizdachel
לִזְחוֹל|lizchol
לְהָזִיד|lehazid
זִיו|ziv
לְהִזְדַּייֵּן|lehizdayen
זַיִן|zayin
לְזַייֵּן|lezayen
זִיעַ|zia
זִיף|zif
לְזַייֵּף|lezayef
זִירָה|zira
זַיִת|zayit
לִזְכּוֹת|lizkot
לְזַכּוֹת|lezakot
זְכוּת|zchut
זִיכּוּי|zikuy
זַכַּאי|zakay
זַכְייָן|zachyan
זָכוּי|zachuy
זַךְ|zach
זְכוּכִית|zchuchit
לִזְכּוֹר|lizkor
לְהַזְכִּיר|lehazkir
לְהִיזָּכֵר|lehizacher
זְכִירָה|zchira
אַזְכָּרָה|azkara
זֵכֶר|zecher
מַזְכֶּרֶת|mazkeret
הַזְכָּרָה|hazkara
אַזְכָּרָה|azkara
תִּזְכּוֹרֶת|tizkoret
זִיכָּרוֹן|zikaron
זָכוּר|zachur
לִזְלוֹג|lizlog
מַזְלֵג|mazleg
לְזַלְזֵל|lezalzel
זַלְזָל|zalzal
לִזְלוֹל|lizlol
לְהַזְלִיף|lehazlif
זִימְזוּם|zimzum
לְזַמְזֵם|lezamzem
זַמְזָם|zamzam
זִימָּה|zima
לְהָזִים|lehazim
מְזִימָּה|mezima
לִזְמוֹם|lizmom
לְזַמֵּן|lezamen
לְהַזְמִין|lehazmin
זָמִין|zamin
הִזְדַּמְּנוּת|hizdamnut
הַזְמָנָה|hazmana
זְמַן|zman
זְמַנִּי|zmani
זְמִינוּת|zminut
מְזוּמָּן|mezuman
לְהִזְדַּמֵּן|lehizdamen
לְזַמֵּר|lezamer
זַמָּר|zamar
זֵמֶר|zemer
תִּזְמוֹרֶת|tizmoret
מִזְמוֹר|mizmor
לִזְמוֹר|lizmor
זַןּ|zan
זְנַבְנַב|znavnav
זָנָב|zanav
לְזַנֵּב|lezanev
לְהִזְדַּנֵּב|lehizdanev
לִזְנוֹחַ|liznoach
לְהַזְנִיחַ|lehazniach
לִזְנוֹת|liznot
לְזַנּוֹת|lezanot
לְזַנֵּק|lezanek
זִינּוּק|zinuk
לְהַזְנִיק|lehaznik
לְזַעְזֵעַ|leza'azea
לְהִזְדַּעְזֵעַ|lehizda'azea
לִזְעוֹם|liz'om
לְהִיזָּעֵם|lehiza'em
זַעַם|za'am
לִזְעוֹף|liz'of
לְהַזְעִיף|lehaz'if
לְהַזְעִיק|lehaz'ik
לִזְעוֹק|liz'ok
אַזְעָקָה|az'aka
לְהִזְדַּעֵק|lehizda'ek
זָעִיר|za'ir
לְזַעֵר|leza'er
לְזַפֵּת|lezapet
לְהִזְדַּקֵּן|lehizdaken
זָקֵן|zaken
זָקָן|zakan
לְהַזְקִין|lehazkin
זָקֵן|zaken
לְהִיזָּקֵף|lehizakef
לְהִזְדַּקֵּף|lehizdakef
זִקְפָּה|zikpa
זָקוּף|zakuf
לִזְקוֹף|lizkof
זִיקּוּק|zikuk
לְזַקֵּק|lezakek
לְהִיזָּקֵק|lehizakek
זִיקּוּק|zikuk
זָקוּק|zakuk
לְהִזְדַּקֵּק|lehizdakek
לְהַזְקִיק|lehazkik
לְהִזְדַּקֵּר|lehizdaker
לְזַרְגֵּג|lezargeg
מְזוּרְגָּג|mezurgag
לְזָרֵז|lezarez
לְהִזְדָּרֵז|lehizdarez
זָרִיז|zariz
זָרָז|zaraz
אֶזְרָח|ezrach
לִזְרוֹחַ|lizroach
זְרִיחָה|zricha
מִזְרָח|mizrach
מִזְרָחָה|mizracha
מִזְרָחִי|mizrachi
לִזְרוֹת|lizrot
לְהִיזָּרוֹת|lehizarot
לְהַזְרִים|lehazrim
זֶרֶם|zerem
תַּזְרִים|tazrim
לִזְרוֹם|lizrom
לִזְרוֹעַ|lizroa
לְהִיזָּרֵעַ|lehizarea
זֶרַע|zera
לִזְרוֹק|lizrok
לְהִיזָּרֵק|lehizarek
לְהַזְרִיק|lehazrik
מִזְרָקָה|mizraka
זְרִיקָה|zrika
זֵר|zer
לְהֵיחָבֵא|lehechave
לְהִתְחַבֵּא|lehitchabe
לְהַחְבִּיא|lehachbi
לְחַבֵּב|lechabev
תַּחְבִּיב|tachbiv
לַחְבּוֹב|lachbov
לְהִתְחַבֵּב|lehitchabev
חִיבָּה|chiba
לַחְבּוֹט|lachbot
לְהֵיחָבֵט|lehechavet
מַחְבֵּט|machbet
לְהִתְחַבֵּט|lehitchabet
חֲבָל|chaval
חוֹבֵל|chovel
לְחַבֵּל|lechabel
לְהֵיחָבֵל|lehechavel
תַּחְבּוּלָה|tachbula
חֲבִילָה|chavila
לַחְבּוֹל|lachbol
לְחַבֵּק|lechabek
לַחְבּוֹק|lachbok
לְהִתְחַבֵּק|lehitchabek
לְהַחְבִּיר|lehachbir
לְחַבֵּר|lechaber
לְהִתְחַבֵּר|lehitchaber
חֲבֵרָה|chavera
הִתְחַבְּרוּת|hitchabrut
מַחְבֶּרֶת|machberet
תַּחְבִּיר|tachbir
חֲבוּרָה|chavura
חֶבְרָה|chevra
חָבֵר|chaver
לַחֲבוֹר|lachavor
חִיבּוּר|chibur
תַּחְבּוּרָה|tachbura
לְהֵיחָבֵשׁ|lehechavesh
לַחְבּוֹשׁ|lachbosh
חוֹבֵשׁ|chovesh
חֲבִיתָה|chavita
מַחְבָת|machvat
לָחוֹג|lachog
חֲגִיגָה|chagiga
חַג|chag
לְהֵיחָגֵג|lehechageg
לַחְגּוֹר|lachgor
חֲגוּרָה|chagura
לְחַדֵּד|lechaded
חַד|chad
חַדּוּת|chadut
מֶחְדָּל|mechdal
לַחְדּוֹל|lachdol
חֵדֶק|chedek
לְהַחְדִּיר|lehachdir
חֶדֶר|cheder
לַחְדּוֹר|lachdor
חֶדֶר אַמְבַּטְיָה|chederambatya
חָדָשׁ|chadash
לְחַדֵּשׁ|lechadesh
לְהִתְחַדֵּשׁ|lehitchadesh
הִתְחַדְּשׁוּת|hitchadshut
חוֹדֶשׁ|chodesh
חַדְשָׁן|chadshan
חַדְשָׁנִי|chadshani
חוֹדְשַׁייִם|chodshayim
לָחוּב|lachuv
לָחוּג|lachug
מְחוּגָה|mechuga
לָחוּד|lachud
חִידָה|chida
חוּט|chut
לְחַווֵּט|lechavet
חֲווָיָה|chavaya
לְהַחֲווֹת|lehachavot
מֶחְווָה|mechva
מַחֲווֶה|machave
לַחֲווֹת|lachavot
לְחַוּוֹת|lechavot
לָחוּל|lachul
לְהִתְחוֹלֵל|lehitcholel
לְהָחִיל|lehachil
לְחוֹלֵל|lecholel
חוּם|chum
חוֹמָה|choma
חוּמוּס|chumus
לָחוּס|lachus
חִיצוֹן|chitzon
חִיצוֹנִי|chitzoni
חוּץ|chutz
לְהִתְחַווֵּר|lehitchaver
לְהַחֲווִיר|lehachavir
חִיווֵּר|chiver
לָחוּשׁ|lachush
לְהָחִישׁ|lehachish
תְּחוּשָׁה|tchusha
חָזֶה|chaze
תַּחֲזִית|tachazit
לַחֲזוֹת|lachazot
לְהִתְחַזּוֹת|lehitchazot
חֲזִית|chazit
הִתְחַזּוּת|hitchazut
מַחֲזֶה|machaze
חוֹזֶה|choze
חוֹזֶה|choze
חֲזִייָּה|chaziya
חֲזִיר|chazir
לְחַזֵּק|lechazek
לְהִתְחַזֵּק|lehitchazek
לְהַחְזִיק|lehachzik
לַחֲזוֹק|lachazok
חוֹזֶק|chozek
חָזָק|chazak
חֲזָקָה|chazaka
חֶזְקָה|chezka
לַחֲזוֹר|lachazor
לְחַזֵּר|lechazer
לְהַחֲזִיר|lehachazir
הֶחְזֵר|hechzer
מַחְזוֹר|machzor
לְהַחֲטִיא|lehachati
לַחֲטוֹא|lachato
לְחַטֵּא|lechate
לְהִתְחַטֵּא|lehitchate
לַחְטוֹב|lachtov
לְהֵיחָטֵב|lehechatev
לְחַטֵּט|lechatet
לְהֵיחָטֵף|lehechatef
לְהַחְטִיף|lehachtif
חָטוּף|chatuf
לַחְטוֹף|lachtof
לְהִתְחַייֵּב|lehitchayev
לְחַייֵּב|lechayev
מְחוּיָּב|mechuyav
חוֹבָה|chova
חַייָּב|chayav
חַייָּב|chayav
חוֹב|chov
חִיּוּב|chiyuv
חִיּוּבִי|chiyuvi
הִתְחַייְּבוּת|hitchayvut
מְחוּיָּבוּת|mechuyavut
לְחַייֵּג|lechayeg
חַייָּט|chayat
לְחַייֵּט|lechayet
חִיּוּת|chiyut
לְהַחֲיוֹת|lehachayot
לִחְיוֹת|lichyot
חַיִּים|chayim
מִחְיָה|michya
תְּחִייָּה|tchiya
חַיָּה|chaya
חַייְזָר|chayzar
לְחַייֵּךְ|lechayech
חִיּוּךְ|chiyuch
חַייְכָן|chaychan
מְחוּיָּךְ|mechuyach
לְחוֹלֵל|lecholel
לְהִתְחוֹלֵל|lehitcholel
חַייָּל|chayal
תְּחוּלָה|tchula
לְחַייֵּל|lechayel
חֵיק|chek
לְחַכּוֹת|lechakot
לְחַכֵּךְ|lechakech
חִיכּוּךְ|chikuch
לְהִתְחַכֵּךְ|lehitchakech
חֵךְ|chech
לְהִתְחַכֵּם|lehitchakem
חוֹכְמָה|chochma
חָכָם|chacham
לַחְכּוֹם|lachkom
לְהַחְכִּים|lehachkim
לְהֵיחָכֵר|lehechacher
לְהַחְכִּיר|lehachkir
לַחְכּוֹר|lachkor
חָלָב|chalav
חֲלָבִי|chalavi
לַחְלוֹב|lachlov
חֲלוּדָה|chaluda
לְהַחְלִיד|lehachlid
חָלוּד|chalud
חוּלְדָּה|chulda
לְחַלְחֵל|lechalchel
לְהִתְחַלְחֵל|lehitchalchel
לְהַחְלִיט|lehachlit
לְחַלֵּט|lechalet
חִילּוּט|chilut
הַחְלָטָה|hachlata
לַחְלוֹט|lachlot
חִילְטוּר|chiltur
לְחַלְטֵר|lechalter
לַחֲלוֹת|lachalot
לְחַלּוֹת|lechalot
מַחֲלָה|machala
לְהִתְחַלּוֹת|lehitchalot
חַלּוֹן|chalon
לְחַלֵּל|lechalel
תְּחִילָּה|tchila
חָלָל|chalal
חֲלִיל|chalil
חָלִילָה|chalila
לְהָחֵל|lehachel
חָלוּל|chalul
חִילוֹנִי|chiloni
חַלָּה|chala
מְחִילָּה|mechila
לְהַחְלִים|lehachlim
חָלוֹם|chalom
לַחְלוֹם|lachlom
חֲלוּפָה|chalufa
לְהַחֲלִיף|lehachalif
לְהִתְחַלֵּף|lehitchalef
חֲלִיפָה|chalifa
הַחְלָפָה|hachlafa
לַחֲלוֹף|lachalof
מֶחְלָף|mechlaf
מַחְלֵף|machlef
חֲלוּפִי|chalufi
לַחֲלוֹץ|lachalotz
לְהֵיחָלֵץ|lehechaletz
לְחַלֵּץ|lechaletz
חָלוּץ|chalutz
חוּלְצָה|chultza
לְחַלֵּק|lechalek
לְהַחֲלִיק|lehachalik
חֲלַקְלַק|chalaklak
חֵלֶק|chelek
חָלָק|chalak
חֲלוּקָּה|chaluka
חֶלְקִיק|chelkik
מְחַלֵּק|mechalek
לַחֲלוֹק|lachalok
לְהִתְחַלֵּק|lehitchalek
לְהֵיחָלֵק|lehechalek
מַחְלָקָה|machlaka
חִילּוּק|chiluk
לְהַחֲלִישׁ|lehachalish
לַחֲלוֹשׁ|lachalosh
לְהִתְחַלֵּשׁ|lehitchalesh
לְהֵיחָלֵשׁ|lehechalesh
חוּלְשָׁה|chulsha
חַלָּשׁ|chalash
לַחֲלוֹשׁ|lachalosh
חָם|cham
לְהַחֲמִיא|lehachami
מַחְמָאָה|machma'a
חֶמְאָה|chem'a
חָמוּד|chamud
חֶמְדָּה|chemda
נֶחְמָד|nechmad
לַחְמוֹד|lachmod
חַמְדָן|chamdan
חַמְדָנוּת|chamdanut
חָמוֹת|chamot
לַחְמוֹל|lachmol
חָמִים|chamim
לְחַמֵּם|lechamem
חוֹם|chom
הִתְחַמְּמוּת|hitchamemut
חַם|cham
לְהִתְחַמֵּם|lehitchamem
חִימּוּם|chimum
לְהַחֲמִיץ|lehachamitz
לַחְמוֹץ|lachmotz
חוּמְצָה|chumtza
חוֹמֶץ|chometz
מַחְמָץ|machmatz
חַמְצָן|chamtzan
חָמוּץ|chamutz
לְהִתְחַמֵּץ|lehitchametz
חֲמִיצָה|chamitza
לְחַמְצֵן|lechamtzen
לְהִתְחַמְצֵן|lehitchamtzen
לְהִתְחַמֵּק|lehitchamek
חֲמַקְמַק|chamakmak
לַחְמוֹק|lachmok
לְהַחְמִיר|lehachmir
חֵימָר|chemar
חוֹמֶר|chomer
חָמוּר|chamur
חֲמוֹר|chamor
לְהִתְחַמֵּשׁ|lehitchamesh
חֲמִישִׁי|chamishi
חָמוּשׁ|chamush
חוֹמֶשׁ|chomesh
לַחְנוֹט|lachnot
לְהֵיחָנֵט|lehechanet
לַחֲנוֹת|lachanot
לְהַחֲנוֹת|lehachanot
מַחֲנֶה|machane
חֲנוּת|chanut
תַּחֲנָה|tachana
חֲנָיָה|chanaya
חֲנִייָּה|chaniya
לְחַנֵּךְ|lechanech
לְהֵיחָנֵךְ|lehechanech
חִינּוּךְ|chinuch
לְהִתְחַנֵּךְ|lehitchanech
חָנִיךְ|chanich
חֲנוּכָּה|chanuka
חִינּוּכִי|chinuchi
לַחֲנוֹךְ|lachanoch
חֲנוּכִּייָּה|chanukiya
לְהִתְחַנֵּן|lehitchanen
לָחוֹן|lachon
מְחוּנָּן|mechunan
מְחוֹנָן|mechonan
חֵן|chen
לְהֵיחֵן|lehechen
לְהִתְחַנֵּף|lehitchanef
לְהַחֲנִיף|lehachanif
חַנְפָן|chanfan
לַחֲנוֹק|lachanok
לְהֵיחָנֵק|lehechanek
חֲנִיקָה|chanika
לְהַחְנִיק|lehachnik
חֶנֶק|chenek
חַנָּק|chanak
מַחֲנָק|machanak
לְהִתְחַסֵּד|lehitchased
חֶסֶד|chesed
חֲסִידָה|chasida
חַסָּה|chasa
לַחֲסוֹת|lachasot
חָסוּת|chasut
חִיסָּיוֹן|chisayon
לְהֵיחָסֵךְ|lehechasech
לַחֲסוֹךְ|lachasoch
חִיסָּכוֹן|chisachon
לְחַסֵּל|lechasel
לְהִתְחַסֵּל|lehitchasel
חִיסּוּל|chisul
לְהֵיחָסֵם|lehechasem
מַחְסוֹם|machsom
לַחְסוֹם|lachsom
לְחַסֵּן|lechasen
מַחְסָן|machsan
מַחְסָנִית|machsanit
חוֹסֶן|chosen
לְהִתְחַסֵּן|lehitchasen
לְהִתְחַסֵּן|lehitchasen
חָסִין|chasin
חֲסִינוּת|chasinut
לְחַסְפֵּס|lechaspes
מְחוּסְפָּס|mechuspas
לְהַחְסִיר|lehachsir
לַחְסוֹר|lachsor
לְחַסֵּר|lechaser
חָסֵר|chaser
חִיסָּרוֹן|chisaron
חוֹסֶר|choser
חִיסּוּר|chisur
חֲסַר תּוֹעֶלֶת|chasarto'elet
לְהֵיחָפֵז|lehechafez
לְחַפּוֹת|lechapot
לָחוֹף|lachof
לְחוֹפֵף|lechofef
לְהִתְחָפֵף|lehitchafef
לַחְפּוֹף|lachpof
לַחְפּוֹף|lachpof
לַחְפּוֹץ|lachpotz
לַחְפּוֹר|lachpor
לְהֵיחָפֵר|lehechafer
לְהִתְחַפֵּר|lehitchaper
חֲפִירָה|chafira
מַחְפֵּר|machper
לְחַפֵּשׂ|lechapes
לְהִתְחַפֵּשׂ|lehitchapes
חִיפּוּשׂ|chipus
חוֹפְשִׁי|chofshi
תַּחְפּוֹשֶׂת|tachposet
חוֹפֶשׁ|chofesh
חוּפְשָׁה|chufsha
לַחְצוֹב|lachtzov
לְהֵיחָצֵב|lehechatzev
מַחְצָב|machtzav
חָצָב|chatzav
לַחֲצוֹת|lachatzot
מַחֲצִית|machatzit
חֲצָאִית|chatza'it
לְהֵיחָצוֹת|lehechatzot
חֶצִי|chetzi
יַחַץ|yachatz
חֲצוֹת|chatzot
לְהִתְחַצֵּף|lehitchatzef
חוּצְפָּה|chutzpa
מְחִיצָּה|mechitza
חֵץ|chetz
לְחַצְצֵר|lechatzetzer
חָצֵר|chatzer
לְחַקּוֹת|lechakot
לְהִתְחַקּוֹת|lehitchakot
חַקְייָן|chakyan
חִיקּוּי|chikuy
חַקְלָאוּת|chakla'ut
חַקְלַאי|chaklay
חַקְלָאִי|chakla'i
חוֹקֶן|choken
חוּקִּי|chuki
לְחוֹקֵק|lechokek
תְּחִיקָּה|tchika
חוֹק|chok
לְהֵיחָקֵק|lehechakek
תְּחִיקָּה|tchika
לַחְקוֹק|lachkok
חֲקִיקָה|chakika
חֲקִיקָה|chakika
לַחְקוֹר|lachkor
לְהֵיחָקֵר|lehechaker
תַּחְקִיר|tachkir
מֶחְקָר|mechkar
חֵקֶר|cheker
לְהֵיחָרֵב|lehecharev
לַחֲרוֹב|lacharov
לְהַחֲרִיב|lehachariv
חוּרְבָּן|churban
חֶרֶב|cherev
לְחַרְבֵּן|lecharben
לְהִתְחַרְבֵּן|lehitcharben
לַחֲרוֹג|lacharog
לַחֲרוֹד|lacharod
לְהֵיחָרֵד|lehechared
לְהַחְרִיד|lehachrid
מַחְרִיד|machrid
חֲרָדָה|charada
לַחֲרוֹז|lacharoz
לְהֵיחָרֵז|lehecharez
חָרוּז|charuz
חֲרִיזָה|chariza
לְהִתְחָרֵז|lehitcharez
לְחַרְחֵר|lecharcher
לַחֲרוֹט|lacharot
לְהֵיחָרֵט|lehecharet
חֲרָטָה|charata
לְהִתְחָרֵט|lehitcharet
לְחַרְטֵט|lechartet
חַרְטָט|chartat
תַּחֲרוּת|tacharut
לְהִתְחָרוֹת|lehitcharot
מִתְחָרֶה|mitchare
הִתְחָרוּת|hitcharut
לַחֲרוֹת|lacharot
לְהַחְרוֹת|lehachrot
לַחֲרוֹךְ|lacharoch
לְהֵיחָרֵךְ|lehecharech
חָרָךְ|charach
לְהַחֲרִים|lehacharim
חֵירוּם|cherum
חֶרֶס|cheres
חַרְסִית|charsit
לְהַחֲרִיף|lehacharif
לְחָרֵף|lecharef
חוֹרֶף|choref
חוֹרְפִּי|chorpi
חָרִיף|charif
לַחְרוֹף|lachrof
לְהִתְחַרְפֵן|lehitcharfen
לְהֵיחָרֵץ|lehecharetz
חָרוּץ|charutz
לַחֲרוֹץ|lacharotz
לַחֲרוֹק|lacharok
חֶרֶק|cherek
חֵירוּת|cherut
לְחָרֵר|lecharer
חוֹר|chor
לַחֲרוֹשׁ|lacharosh
לְהַחֲרִישׁ|lehacharish
לְהֵיחָרֵשׁ|lehecharesh
חֵירֵשׁ|cheresh
מַחְרֵשָׁה|machresha
לְהִתְחָרֵשׁ|lehitcharesh
לַחֲרוֹת|lacharot
לַחְשׁוֹב|lachshov
לְהֵיחָשֵׁב|lehechashev
לְחַשֵּׁב|lechashev
לְהַחְשִׁיב|lehachshiv
לְהִתְחַשֵּׁב|lehitchashev
הִתְחַשְּׁבוּת|hitchashvut
חִישּׁוּב|chishuv
מַחְשֵׁב|machshev
חַשָּׁב|chashav
חֶשְׁבּוֹן|cheshbon
חָשׁוּב|chashuv
חֶשְׁבּוֹנִית|cheshbonit
מַחְשָׁבָה|machshava
לְהִתְחַשְׁבֵּן|lehitchashben
לְחַשְׁבֵּן|lechashben
לַחְשׁוֹד|lachshod
לְהֵיחָשֵׁד|lehechashed
לְהַחְשִׁיד|lehachshid
חָשׁוּד|chashud
חֲשָׁד|chashad
חֲשַׁאי|chashay
לְהַחֲשׁוֹת|lehachashot
לַחְשׁוֹךְ|lachshoch
לְהַחְשִׁיךְ|lehachshich
חוֹשֶׁךְ|choshech
לְחַשֵּׁל|lechashel
לְהִתְחַשֵּׁל|lehitchashel
לְחַשְׁמֵל|lechashmel
לְהִתְחַשְׁמֵל|lehitchashmel
חַשְׁמָל|chashmal
חַשְׁמָלִי|chashmali
לְהֵיחָשֵׂף|lehechasef
חֲשִׂיפָה|chasifa
חַשְׂפָן|chasfan
חַשְׂפָנִית|chasfanit
חַשְׂפָנוּת|chasfanut
לַחֲשׂוֹף|lachasof
לְחַשֵּׁק|lechashek
לְהִתְחַשֵּׁק|lehitchashek
חֵשֶׁק|cheshek
לְהֵיחָשֵׁק|lehechashek
לַחְשׁוֹק|lachshok
לַחְשׁוֹשׁ|lachshosh
חֲשָׁשׁ|chashash
חָתוּל|chatul
חֲתוּלָה|chatula
חֲתוּלִי|chatuli
לַחְתּוֹךְ|lachtoch
לְהֵיחָתֵךְ|lehechatech
חֲתָךְ|chatach
חָתִיךְ|chatich
חֲתִיכָה|chaticha
לְחַתֵּךְ|lechatech
חָתוּךְ|chatuch
לְחַתֵּל|lechatel
חִיתּוּל|chitul
חֲתַלְתּוּל|chataltul
חֲתַלְתּוּלָה|chataltula
חֲתַלְתּוּלוֹן|chataltulon
חֲתַלְתּוּלוֹנֶת|chataltulonet
חֲתִימָה|chatima
לְהֵיחָתֵם|lehechatem
לְהַחְתִּים|lehachtim
לַחְתּוֹם|lachtom
לְחַתֵּן|lechaten
חֲתוּנָּה|chatuna
חָתָן|chatan
לְהִתְחַתֵּן|lehitchaten
מַחְתֶּרֶת|machteret
לַחְתּוֹר|lachtor
לְטַאְטֵא|letate
מַטְאֲטֵא|mat'ate
טָבוּחַ|tavuach
לִטְבּוֹחַ|litboach
לְהִיטָּבֵחַ|lehitaveach
טַבָּח|tabach
מִטְבָּח|mitbach
טֶבַח|tevach
לִטְבּוֹל|litbol
לְהִיטָּבֵל|lehitavel
לְהַטְבִּיל|lehatbil
לִטְבּוֹעַ|litboa
לְהִיטָּבֵעַ|lehitavea
לְהַטְבִּיעַ|lehatbia
טִבְעוֹנִי|tiv'oni
מַטְבֵּעַ|matbea
טֶבַע|teva
טִבְעִי|tiv'i
טִבְעוֹנוּת|tiv'onut
טַבַּעַת|taba'at
לְהַטְבִּיעַ|lehatbia
לְטַגֵּן|letagen
מְטוּגָּן|metugan
לְטַהֵר|letaher
לִטְהוֹר|lithor
לְהִיטָּהֵר|lehitaher
לְהִיטַּהֵר|lehitaher
טָהוֹר|tahor
טוֹהַר|tohar
לָטוּב|latuv
טוֹבָה|tova
טוֹב|tov
טוּזִיג|tuzig
לְהָטִיחַ|lehatiach
לְטַווֵּחַ|letaveach
טְווָח|tvach
לִטְווֹת|litvot
לְהַטִּיל|lehatil
לְהָטִיס|lehatis
לָטוּס|latus
מָטוֹס|matos
טִיסָה|tisa
מַטְחֵנָה|matchena
לִטְחוֹן|litchon
טָחוּן|tachun
טְחִינָה|tchina
לְטַייֵּב|letayev
טִיחַ|tiach
טִיּוּחַ|tiyuach
טִיּוּל|tiyul
טַייֶּלֶת|tayelet
לְטַייֵּל|letayel
טַייָּס|tayas
טִירָה|tira
טִירוֹן|tiron
טִירוֹנוּת|tironut
לְטַכֵּס|letakes
לְטַלְגְּרֵף|letalgref
טֶלֶווִיזְיָה|televizya
לְטַלְטֵל|letaltel
לְהִיטַּלְטֵל|lehitaltel
טַלִּית|talit
טַל|tal
טֶלֶף|telef
לְטַלֵּף|letalef
טֶלֶפוֹן|telefon
לְטַלְפֵּן|letalpen
לְטַמֵּא|letame
לְהִיטָּמֵא|lehitame
לְטַמְטֵם|letamtem
לִטְמוֹן|litmon
לְהִיטָּמֵן|lehitamen
לְהַטְמִין|lehatmin
לְהַטְמִיעַ|lehatmia
לְהִיטָּמֵעַ|lehitamea
לְטַנֵּף|letanef
טִינּוֹפֶת|tinofet
לִטְעוֹת|lit'ot
לְהַטְעוֹת|lehat'ot
טָעוּת|ta'ut
לִטְעוֹם|lit'om
לְהַטְעִים|lehat'im
טָעִים|ta'im
טְעִימָה|te'ima
מַטְעָם|mat'am
טַעַם|ta'am
לְהַטְעִין|lehat'in
לִטְעוֹן|lit'on
מִטְעָן|mit'an
מַטְעֵן|mat'en
לְהִיטָּעֵן|lehita'en
לִטְפּוֹחַ|litpoach
לְטַפֵּחַ|letapeach
טְפִיחָה|tficha
לְטַפְטֵף|letaftef
טִיפְטוּף|tiftuf
לְטַפֵּל|letapel
לְהִיטָּפֵל|lehitafel
טִיפּוּל|tipul
לִטְפּוֹל|litpol
לְטַפֵּס|letapes
טוֹפֶס|tofes
לִטְפּוֹף|litpof
מְטוּפָּשׁ|metupash
טִיפֵּשׁ|tipesh
טֶקֶס|tekes
טָרוּד|tarud
לְהַטְרִיד|lehatrid
הַטְרָדָה|hatrada
מִטְרָד|mitrad
לְהַטְרִיחַ|lehatriach
לִטְרוֹחַ|litroach
לְטַרְטֵר|letarter
טְרִיּוּת|triyut
טָרִי|tari
טֶרֶם|terem
לִטְרוֹף|litrof
לְהִיטָּרֵף|lehitaref
לְהַטְרִיף|lehatrif
לְטַרְפֵּד|letarped
טַרְפֶּדֶת|tarpedet
לְהִיטָּרֵק|lehitarek
לִטְרוֹק|litrok
טָרֶשֶׁת|tareshet
לְהִתְטַשְׁטֵשׁ|lehittashtesh
לְטַשְׁטֵשׁ|letashtesh
לְהִיטַּשְׁטֵשׁ|lehitashtesh
לִיאוֹת|li'ot
לְהוֹאִיל|leho'il
לְהִיווָּאֵשׁ|lehiva'esh
לְהִתְייָאֵשׁ|lehitya'esh
יֵיאוּשׁ|ye'ush
מְייָאֵשׁ|meya'esh
לְייַבֵּא|leyabe
לְייַבֵּב|leyabev
לְהוֹבִיל|lehovil
מְיוּבָּל|meyubal
יַבֶּלֶת|yabelet
מוֹבִיל|movil
מַבּוּל|mabul
הוֹבָלָה|hovala
לְייַבֵּל|leyabel
לְהִתְייַבֵּשׁ|lehityabesh
לִיבוֹשׁ|livosh
יָבֵשׁ|yavesh
יִיבּוּשׁ|yibush
יַבֶּשֶׁת|yabeshet
יַבָּשָׁה|yabasha
לְייַבֵּשׁ|leyabesh
תּוּגָה|tuga
לְייַגֵּעַ|leyagea
לְהִתְייַגֵּעַ|lehityagea
יָגוֹר|yagor
יָד|yad
יָד|yad
לְהִתְייַדֵּד|lehityaded
יְדִידוּת|yedidut
יָדִיד|yadid
לְהוֹדוֹת|lehodot
לִידוֹת|lidot
תּוֹדָה|toda
לְייַדּוֹת|leyadot
מוֹדָעָה|moda'a
לָדַעַת|lada'at
לְהוֹדִיעַ|lehodia
לְהִיווָּדֵעַ|lehivadea
לְייַדֵּעַ|leyadea
דַּעַת|da'at
יְדִיעָה|yedi'a
יֶדַע|yeda
יַדְעָן|yad'an
הוֹדָעָה|hoda'a
מַדָּע|mada
מֵידָע|meda
מַדְעָן|mad'an
יָדוּעַ|yadua
מוֹדִיעִין|modi'in
יַהֲדוּת|yahadut
יְהוּדִי|yehudi
יְהוּדִיָּה|yehudiya
יְהוּדִי|yehudi
יַהֲדוּת|yahadut
יַהֲלוֹם|yahalom
יוֹם|yom
יוֹמָן|yoman
לְהִתְייַווֵּן|lehityaven
לְהוֹזִיל|lehozil
יַזָּם|yazam
מֵיזָם|mezam
יוֹזְמָה|yozma
לִיזוֹם|lizom
לְהַזִּיעַ|lehazia
לְהִתְייַחֵד|lehityached
מְיוּחָד|meyuchad
יִיחוּד|yichud
יַחַד|yachad
לְייַחֵד|leyached
יַחְדָּיו|yachdav
יָחִיד|yachid
לְייַחֵל|leyachel
תּוֹחֶלֶת|tochelet
לְהִתְייַחֵס|lehityaches
יַחַס|yachas
לְייַחֵס|leyaches
לְהֵיטִיב|lehetiv
מֵיטָב|metav
מֵיטָבִי|metavi
יַיִן|yayin
לְהוֹכִיחַ|lehochiach
לְהִיווָּכֵחַ|lehivacheach
לוּכַל|luchal
יְכוֹלֶת|yecholet
לָלֶדֶת|laledet
לְהוֹלִיד|leholid
לְהִיווָּלֵד|lehivaled
לְהִתְייַלֵּד|lehityaled
יֶלֶד|yeled
יַלְדָּה|yalda
מוֹלֶדֶת|moledet
לֵידָה|leda
יַלְדוּת|yaldut
יְלוּדָה|yeluda
לְייַלֵּד|leyaled
תּוֹלָדָה|tolada
לְייַלֵּל|leyalel
יְלָלָה|yelala
תּוֹלַעַת|tola'at
יַמָּה|yama
יַמִּי|yami
יָם|yam
מְיוּמָּן|meyuman
מְיוּמָּנוּת|meyumanut
לְהִתְייַמֵּר|lehityamer
יוֹמְרָה|yomra
לְהוֹנוֹת|lehonot
לְייַנֵּן|leyanen
לְהֵינִיק|lehenik
לִינוֹק|linok
תִּינוֹק|tinok
תִּינוֹקֶת|tinoket
לִיסוֹד|lisod
לְהִיווָּסֵד|lehivased
יְסוֹדִיּוּת|yesodiyut
יְסוֹדִי|yesodi
יְסוֹד|yesod
מוֹסָד|mosad
יִיסּוּד|yisud
לְייַסֵּד|leyased
מַסָּד|masad
יוֹסֵף|yosef
לְהוֹסִיף|lehosif
לְהִיווָּסֵף|lehivasef
תּוֹסֶפֶת|tosefet
לְהִיתּוֹסֵף|lehitosef
הוֹסָפָה|hosafa
יִיסּוּרִים|yisurim
לְהִתְייַסֵּר|lehityaser
לְייַסֵּר|leyaser
לְהִיווָּעֵד|lehiva'ed
מוּעָד|mu'ad
לִיעוֹד|li'od
יַעַד|ya'ad
לְייַעֵד|leya'ed
מוֹעֵד|mo'ed
מוֹעֲדוֹן|mo'adon
לְהִיווָּעֵז|lehiva'ez
תּוֹעֶלֶת|to'elet
לְהוֹעִיל|leho'il
לְייַעֵל|leya'el
יָעֵן|ya'en
יַעַן|ya'an
לִיעוֹף|li'of
יַעֶפֶת|ya'efet
לָעוּץ|la'utz
לְהִתְייַעֵץ|lehitya'etz
לְהִיווָּעֵץ|lehiva'etz
עֵיצָה|etza
יִיעוּץ|yi'utz
לְייַעֵץ|leya'etz
הִתְייַעֲצוּת|hitya'atzut
מוֹעָצָה|mo'atza
יְפֵהפֶה|yefefe
לְהִתְייַפֵּחַ|lehityapeach
לְייַפּוֹת|leyapot
יוֹפִי|yofi
יוֹפִי|yofi
לִיפוֹת|lifot
יָפֶה|yafe
יַפְיוּף|yafyuf
מוֹפָע|mofa
לְהוֹפִיעַ|lehofia
תּוֹפָעָה|tofa'a
צֵאת|tzet
לָצֵאת|latzet
לְהוֹצִיא|lehotzi
לְייַצֵּא|leyatze
תּוֹצָאָה|totza'a
מוֹצָא|motza
יְצִיאָה|yetzi'a
נִיצָּב|nitzav
לְהִתְייַצֵּב|lehityatzev
לְהַצִּיב|lehatziv
מַצָּב|matzav
נִיצָּב|nitzav
יַצִּיב|yatziv
יַצִּיבוּת|yatzivut
לְייַצֵּב|leyatzev
הִתְייַצְּבוּת|hityatzvut
לְהַצִּיג|lehatzig
הַצָּגָה|hatzaga
מַצֶּגֶת|matzeget
לְייַצֵּג|leyatzeg
יִיצּוּג|yitzug
תְּצוּגָה|tetzuga
לְהַצִּיעַ|lehatzia
הֶיצֵּעַ|hetzea
הַצָּעָה|hatza'a
לִיצוֹק|litzok
מוּצָק|mutzak
לְהִיווָּצֵק|lehivatzek
לִיצוֹר|litzor
לְהִיווָּצֵר|lehivatzer
יִיצּוּר|yitzur
הִיווָּצְרוּת|hivatzrut
יֵצֶר|yetzer
מוּצָר|mutzar
יַצְרָן|yatzran
יְצוּר|yetzur
יְצִיר|yetzir
יָצוּר|yatzur
לְייַצֵּר|leyatzer
יְצִירָה|yetzira
יְצִירָתִי|yetzirati
תּוֹצֶרֶת|totzeret
לְהַצִּית|lehatzit
מַצִּית|matzit
הַצָּתָה|hatzata
מַצָּת|matzat
יֶקֶב|yekev
מוֹקֵד|moked
לִיקוֹד|likod
לְהוֹקִיעַ|lehokia
לְהִתְייַקֵּר|lehityaker
לְהוֹקִיר|lehokir
יַקִּיר|yakir
יַקִּירָה|yakira
לִיקוֹר|likor
יָקָר|yakar
לְייַקֵּר|leyaker
הִתְייַקְּרוּת|hityakrut
מוֹקֵשׁ|mokesh
לִירוֹא|liro
לְהִתְייָרֵא|lehityare
נוֹרָא|nora
הוֹרָאָה|hora'a
לְהוֹרִיד|lehorid
יְרִידָה|yerida
לָרֶדֶת|laredet
יָרוּד|yarud
יָרֵחַ|yareach
לְייָרֵט|leyaret
לִירוֹט|lirot
לִירוֹת|lirot
לְהוֹרוֹת|lehorot
לְהִייָּרוֹת|lehiyarot
יֶרִי|yeri
תּוֹרָה|tora
מוֹרֶה|more
יָרֵךְ|yarech
יַרְקוּת|yarkut
יֶרֶק|yerek
יָרָק|yarak
לִירוֹק|lirok
לְהוֹרִיק|lehorik
יַרְקָן|yarkan
יַרְקָן|yarkan
יָרוֹק|yarok
יְרַקְרַק|yerakrak
לָרֶשֶׁת|lareshet
לְהוֹרִישׁ|lehorish
יְרוּשָּׁה|yerusha
לְהִיווָּרֵשׁ|lehivaresh
יֵשׁ|yesh
תּוֹשָׁב|toshav
לָשֶׁבֶת|lashevet
לְהִתְייַשֵּׁב|lehityashev
לְייַשֵּׁב|leyashev
לְהוֹשִׁיב|lehoshiv
יְשִׁיבָה|yeshiva
יִישּׁוּב|yishuv
יוֹשֵׁב|yoshev
יָשׁוּב|yashuv
יֵשׁוּת|yeshut
לְהוֹשִׁיט|lehoshit
לְייַשֵּׂם|leyasem
לִישׁוֹן|lishon
שֵׁינָה|shena
יָשָׁן|yashan
לְהִתְייַשֵּׁן|lehityashen
נוֹשָׁן|noshan
לְהוֹשִׁיעַ|lehoshia
לְהִיווָּשֵׁעַ|lehivashea
יֶשַׁע|yesha
יָשְׁפֶה|yashfe
לְהִתְייַשֵּׁר|lehityasher
יִישּׁוּר|yishur
יָשָׁר|yashar
יָשִׁיר|yashir
לְייַשֵּׁר|leyasher
לְהֵישִׁיר|leheshir
מִישׁוֹר|mishor
יָתֵד|yated
יַתּוּשׁ|yatush
לִיתוֹם|litom
לְהִתְייַתֵּם|lehityatem
יֶתֶר|yeter
יֶתֶר|yeter
מֵיתָר|metar
לְהוֹתִיר|lehotir
לְהִיווָּתֵר|lehivater
יִתְרוֹן|yitron
יוֹתֵר|yoter
מְיוּתָּר|meyutar
לְייַתֵּר|leyater
כְּ־|ke
לִכְאוֹב|lich'ov
לְהַכְאִיב|lehach'iv
כְּאֵב|ke'ev
כְּאִילּוּ|ke'ilu
כָּאן|kan
כַּאֲשֶׁר|ka'asher
לְהִתְכַּבֵּד|lehitkabed
לְהַכְבִּיד|lehachbid
לִכְבּוֹד|lichbod
כָּבוֹד|kavod
כָּבֵד|kaved
כְּבִידָה|kvida
כִּיבּוּד|kibud
לְכַבֵּד|lechabed
לְכַבּוֹת|lechabot
לְהִיכָּבוֹת|lehikavot
כַּבַּאי|kabay
כִּיבּוּי|kibuy
לִכְבּוֹת|lichbot
לִכְבּוֹל|lichbol
לְהִיכָּבֵל|lehikavel
לְכַבֵּס|lechabes
מִכְבָּסָה|michbasa
כְּבִיסָה|kvisa
לְהַכְבִּיר|lehachbir
כְּבָר|kvar
כֶּבֶשׂ|keves
לְהִיכָּבֵשׁ|lehikavesh
כְּבִישָׁה|kvisha
כְּבִישׁ|kvish
כִּבְשָׂה|kivsa
לִכְבּוֹשׁ|lichbosh
כְּגוֹן|kegon
כְּדַאי|keday
כַּדּוּר|kadur
כַּדּוּרֶגֶל|kaduregel
כְּדֵי|kedei
לְהִתְכַּדֵּר|lehitkader
לְכַדְרֵר|lechadrer
כֹּה|ko
לִכְהוֹת|lichhot
לְהִתְכַּהוֹת|lehitkahot
כֵּהֶה|kehe
לְכַהֵן|lechahen
כּוֹבַע|kova
כּוֹחַ|koach
לִכְווֹת|lichvot
לְהִיכָּווֹת|lehikavot
כּוֹכָב|kochav
לְהָכִיל|lehachil
מְכוּלָה|mechula
מֵיכָל|mechal
תְּכוּלָה|tchula
לְהָכִין|lehachin
לְכַווֵּן|lechaven
לְכוֹנֵן|lechonen
לְהִתְכַּווֵּן|lehitkaven
לְהִתְכּוֹנֵן|lehitkonen
לְהִיכּוֹן|lehikon
לְהַכְווִין|lehachvin
כַּווָּנָה|kavana
כִּיוּוּן|kivun
מָכוֹן|machon
תְּכוּנָה|tchuna
מוּכָן|muchan
נָכוֹן|nachon
הֲכָנָה|hachana
מְכוֹנִית|mechonit
כּוֹנְנוּת|konenut
כּוֹנָן|konan
כּוֹנָן|konan
מְכִינָה|mechina
כּוֹס|kos
לְכַווֵּץ|lechavetz
לְהִתְכַּווֵּץ|lehitkavetz
הִתְכַּווְּצוּת|hitkavtzut
כִּיוּוּץ|kivutz
כַּווֶּרֶת|kaveret
כּוּרְסָה|kursa
לְכַזֵּב|lechazev
לְהִיכָּזֵב|lehikazev
לְהַכְזִיב|lehachziv
לְהִיכָּחֵד|lehikached
לְהַכְחִיד|lehachchid
כָּחוֹל|kachol
כְּחַלְחַל|kchalchal
מִכְחוֹל|michchol
לְהַכְחִיל|lehachchil
לְהַכְחִישׁ|lehachchish
לְהִתְכַּחֵשׁ|lehitkachesh
כִּי|ki
כִּיּוֹר|kiyor
כִּיכָּר|kikar
לְכַייֵּל|lechayel
כַּייָּס|kayas
כִּיס|kis
לְכַייֵּס|lechayes
לְכַייֵּף|lechayef
כֵּיף|kef
כֵּיפִי|kefi
כָּךְ|kach
לְכַכֵּב|lechakev
כִּכָּר|kikar
לִכְלוֹא|lichlo
לְהִיכָּלֵא|lehikale
כֶּלֶא|kele
כָּלוּא|kalu
כֶּלֶב|kelev
כְּלַבְלַב|klavlav
מַכְלֵב|machlev
כְּלִיב|kliv
לְהַכְלִיב|lehachliv
כְּלוּם|klum
לְכַלּוֹת|lechalot
לִכְלוֹת|lichlot
לְהִתְכַּלּוֹת|lehitkalot
כְּלִי|kli
כִּלְיָה|kilya
לְהִתְכַּלְכֵּל|lehitkalkel
כַּלְכָּלָה|kalkala
לְכַלְכֵּל|lechalkel
לְהִיכָּלֵל|lehikalel
כְּלָל|klal
מִכְלָלָה|michlala
מִכְלוֹל|michlol
כּוֹל|kol
כּוֹלֵל|kolel
כְּלָלִי|klali
לְהַכְלִיל|lehachlil
כְּלָלוּת|klalut
לִכְלוֹל|lichlol
כָּלוּל|kalul
כַּלָּה|kala
לְהַכְלִים|lehachlim
לְהִיכָּלֵם|lehikalem
כְּלַפֵּי|klapei
לִכְמוֹהַּ|lichmoah
כַּמָּה|kama
כְּמוֹ|kmo
כַּמּוּבָן|kamuvan
כְּמוֹת|kmot
כַּמּוּת|kamut
כִּמְעַט|kim'at
כִּימּוּת|kimut
לְכַּמֵּת|lekamet
כֵּן|ken
כַּן צִיּוּר|kantziyur
כְּנֶגֶד|keneged
לְכַנּוֹת|lechanot
כִּינּוּי|kinuy
לְהִתְכַּנּוֹת|lehitkanot
כִּינָּה|kina
כַּן|kan
לְהִיכָּנֵס|lehikanes
לְהַכְנִיס|lehachnis
לְכַנֵּס|lechanes
לְהִתְכַּנֵּס|lehitkanes
כְּנֶסֶת|kneset
כְּנִיסָה|knisa
הַכְנָסָה|hachnasa
כֶּנֶס|kenes
כִּינּוּס|kinus
מִכְנָסַייִם|michnasayim
כְּנֵסִייָּה|knesiya
הִתְכַּנְּסוּת|hitkansut
לְהַכְנִיעַ|lehachnia
לְהִיכָּנֵעַ|lehikanea
הִיכָּנְעוּת|hikan'ut
כָּנָף|kanaf
כִּינּוֹר|kinor
כַּנִּרְאֶה|kanir'e
כִּיסֵּא|kise
כֵּס|kes
לְכַסֵּחַ|lechaseach
לְכַסּוֹת|lechasot
לְהִתְכַּסּוֹת|lehitkasot
מִכְסָה|michsa
מִכְסֶה|michse
כִּיסּוּי|kisuy
כְּסִיל|ksil
לִכְסוֹס|lichsos
לְהַכְסִיף|lehachsif
לְהִיכָּסֵף|lehikasef
כַּסְפּוֹמָט|kaspomat
כֶּסֶף|kesef
כַּסֶּפֶת|kasefet
כַּסְפִּי|kaspi
לִכְעוֹס|lich'os
לְהַכְעִיס|lehach'is
כַּעַס|ka'as
לְכַעֵר|lecha'er
לִכְפּוֹת|lichpot
לְהִיכָּפוֹת|lehikafot
כָּפוּי|kafuy
כְּפִייָּה|kfiya
כַּפְכָּף|kafkaf
כָּפוּל|kaful
לִכְפּוֹל|lichpol
לְהַכְפִּיל|lehachpil
הַכְפָּלָה|hachpala
כִּפְלַייִם|kiflayim
כֶּפֶל|kefel
לְהַכְפִיף|lehachfif
כָּפִיף|kafif
לְכוֹפֵף|lechofef
כִּיפָּה|kipa
לְהִתְכּוֹפֵף|lehitkofef
כָּפִיף|kafif
כְּפִיפָה|kfifa
כְּפִיפָה|kfifa
לָכוֹף|lachof
כְּפָפָה|kfafa
כַּף|kaf
כַּף|kaf
לִכְפּוֹר|lichpor
לְכַפֵּר|lechaper
כְּפָר|kfar
כַּפָּרָה|kapara
כִּיפּוּר|kipur
לְהַכְפִּישׁ|lehachpish
לִכְפּוֹת|lichpot
לְהִיכָּפֵת|lehikafet
כַּפְתּוֹר|kaftor
לְכַפְתֵּר|lechafter
לְהִתְכַּרְבֵּל|lehitkarbel
כָּרֶגַע|karega
כְּרוּב|kruv
כְּרוּב|kruv
לְהַכְרִיז|lehachriz
כָּרוֹז|karoz
כְּרוּז|kruz
מוּכְרָח|muchrach
לְהַכְרִיחַ|lehachriach
כּוֹרַח|korach
הֶכְרֵחִי|hechrechi
הֶכְרֵחַ|hechreach
כַּרְטִיס|kartis
לִכְרוֹת|lichrot
מִכְרֶה|michre
לְהִיכָּרוֹת|lehikarot
כְּרִייָּה|kriya
כָּרִישׁ|karish
כָּרוּךְ|karuch
לִכְרוֹךְ|lichroch
כְּרוּכִית|kruchit
לְהִיכָּרֵךְ|lehikarech
כֶּרֶךְ|kerech
תַּכְרִיכִים|tachrichim
תַּכְרִיךְ|tachrich
כָּרִיךְ|karich
כְּרִיכָה|kricha
כַּרְכּוֹב|karkov
כַּרְכּוֹם|karkom
לְכַרְכֵּר|lecharker
לְכַרְסֵם|lecharsem
כִּירְסוּם|kirsum
לְהַכְרִיעַ|lehachria
לִכְרוֹעַ|lichroa
כֶּרַע|kera
לְהִיכָּרֵת|lehikaret
לִכְרוֹת|lichrot
תַּכְשִׁיט|tachshit
לְכַשְׁכֵּשׁ|lechashkesh
לְהִיכָּשֵׁל|lehikashel
לְהַכְשִׁיל|lehachshil
מִכְשׁוֹל|michshol
כִּישָּׁלוֹן|kishalon
כֶּשֶׁל|keshel
לִכְשׁוֹל|lichshol
לְכַשֵּׁף|lechashef
כִּישּׁוּף|kishuf
לְהַכְשִׁיר|lehachshir
כָּשֵׁר|kasher
לִכְשׁוֹר|lichshor
כִּשְׁרוֹן|kishron
תַּכְשִׁיר|tachshir
כַּשְׁרוּת|kashrut
הֶכְשֵׁר|hechsher
כָּשִׁיר|kashir
לִכְתּוֹב|lichtov
לְהִיכָּתֵב|lehikatev
לְהַכְתִּיב|lehachtiv
לְהִתְכַּתֵּב|lehitkatev
כַּתָּב|katav
הִתְכַּתְּבוּת|hitkatvut
כְּתִיבָה|ktiva
הַכְתָּבָה|hachtava
כַּתָּבָה|katava
מִכְתָּב|michtav
כְּתָב|ktav
תִּכְתּוֹבֶת|tichtovet
כְּתוֹבֶת|ktovet
כַּתְבָן|katvan
תַּכְתִּיב|tachtiv
כָּתוּב|katuv
לְכַתֵּב|lechatev
כְּתִיב|ktiv
כּוֹתֶל|kotel
לְהַכְתִּים|lehachtim
כֶּתֶם|ketem
כָּתוֹם|katom
כּוּתּוֹנֶת|kutonet
כָּתֵף|katef
לְכַתֵּר|lechater
לְהַכְתִּיר|lehachtir
כֶּתֶר|keter
לְהִתְכַּתֵּשׁ|lehitkatesh
מַכְתֵּשׁ|machtesh
לִכְתּוֹשׁ|lichtosh
לִכְתּוֹת|lichtot
כִּיתָּה|kita
לְ־|le
לֹא|lo
לְאוֹרֶךְ|le'orech
לְאַחַר|le'achar
לְאַט|le'at
לְהַלְאוֹת|lehal'ot
מַלְאָךְ|mal'ach
מְלָאכָה|melacha
לְהַלְאִים|lehal'im
לְאוֹם|le'om
לְאוּמִּי|le'umi
לְאָן|le'an
לֵב|lev
לְלַבֵּב|lelabev
לָבִיד|lavid
לְהִתְלַבֵּט|lehitlabet
הִתְלַבְּטוּת|hitlabtut
לְלַבּוֹת|lelabot
לְלַבְלֵב|lelavlev
לְלַבֵּן|lelaben
לְהַלְבִּין|lehalbin
מַלְבֵּן|malben
לָבָן|lavan
לְבָנָה|levana
לְבֵנָה|levena
לוֹבֶן|loven
לִלְבּוֹשׁ|lilbosh
לְהִתְלַבֵּשׁ|lehitlabesh
לְהַלְבִּישׁ|lehalbish
הַלְבָּשָׁה|halbasha
תִּלְבּוֹשֶׁת|tilboshet
לְבוּשׁ|levush
לָבוּשׁ|lavush
לְהִילָּבֵשׁ|lehilavesh
לְגַבֵּי|legabei
מַלְגֵּז|malgez
מַלְגֵּזָה|malgeza
לְלַגְלֵג|lelagleg
לִלְגּוֹם|lilgom
לְדִבְרֵי|ledivrei
לְהַלְהִיב|lehalhiv
לְהִתְלַהֵב|lehitlahev
לְהִילָּהֵב|lehilahev
לִלְהוֹב|lilhov
לֶהָבָה|lehava
לִלְהוֹט|lilhot
לְהִתְלַהֵט|lehitlahet
לַהַט|lahat
לָהִיט|lahit
לִלְהוֹת|lilhot
לַהֲקָה|lahaka
לַהַק|lahak
לְלַהֵק|lelahek
לְהִתְלַהֵק|lehitlahek
הַלְווָאָה|halva'a
לִווְייָתָן|livyatan
לוּחַ|luach
לוּחִית|luchit
לְהָלִיט|lehalit
לִלְווֹת|lilvot
לְהַלְווֹת|lehalvot
לְהִתְלַוּוֹת|lehitlavot
לְהִילָּווֹת|lehilavot
לִיוּוּי|livuy
לַווְייָן|lavyan
לְלַוּוֹת|lelavot
לוּלָאָה|lula'a
לוּלָב|lulav
לְהִתְלוֹנֵן|lehitlonen
מָלוֹן|malon
תְּלוּנָה|tluna
מְלוּנָה|meluna
לְהַלִּין|lehalin
לְהָלִין|lehalin
לָלוּן|lalun
לָלוּשׁ|lalush
לַח|lach
לֶחִי|lechi
לְלַחֵךְ|lelachech
לִלְחוֹךְ|lilchoch
לִלְחוֹם|lilchom
לְהִילָּחֵם|lehilachem
לְהַלְחִים|lehalchim
לְחִימָה|lechima
לֶחֶם|lechem
מַלְחֵם|malchem
מִלְחָמָה|milchama
לְהַלְחִין|lehalchin
לַחַן|lachan
לְהַלְחִיץ|lehalchitz
לִלְחוֹץ|lilchotz
לְהִילָּחֵץ|lehilachetz
לְחִיצָה|lechitza
לַחַץ|lachatz
לִלְחוֹשׁ|lilchosh
לְהִתְלַחֵשׁ|lehitlachesh
לְהִתְלַחְשֵׁשׁ|lehitlachshesh
לְלַטֵּף|lelatef
לִלְטוֹף|liltof
לִלְטוֹשׁ|liltosh
לְלַטֵּשׁ|lelatesh
לִיטּוּשׁ|litush
לְיַד|leyad
לֵילִי|leili
לַיְלָה|layla
לִילָךְ|lilach
לְהִתְלוֹצֵץ|lehitlotzetz
מֵלִיץ|melitz
לָלִיץ|lalitz
לִלְכּוֹד|lilkod
לְלַכֵּד|lelaked
לְהִתְלַכֵּד|lehitlaked
מַלְכּוֹדֶת|malkodet
לָכוּד|lachud
לִיכּוּד|likud
לְהִילָּכֵד|lehilached
לְלַכְלֵךְ|lelachlech
לְהִתְלַכְלֵךְ|lehitlachlech
מְלוּכְלָךְ|meluchlach
לִיכְלוּךְ|lichluch
לְלַכְסֵן|lelachsen
לַכְסִין|lachsin
לִיכְסוּן|lichsun
לִלְמוֹד|lilmod
לְלַמֵּד|lelamed
לְהִילָּמֵד|lehilamed
לְהִתְלַמֵּד|lehitlamed
תַּלְמוּד|talmud
תַּלְמִיד|talmid
לִימּוּד|limud
לָמוּד|lamud
לַמָּה|lama
לְמַעַן|lema'an
לִלְעוֹג|lil'og
לוֹעֵז|lo'ez
לוֹעֲזִי|lo'azi
לוֹעֲזִיּוּת|lo'aziyut
לְהַלְעִיט|lehal'it
לְלַעְלֵעַ|lela'alea
לִלְעוֹס|lil'os
לְפִי|lefi
לִפְנֵי|lifnei
לְלַפֵּף|lelapef
לִלְפּוֹת|lilpot
לְפִיתָה|lefita
לְהִילָּקֵחַ|lehilakeach
לְהִתְלַקֵּחַ|lehitlakeach
לָקוֹחַ|lakoach
לָקַחַת|lakachat
לֶקַח|lekach
לְקִיחָה|lekicha
לְהִילָּקֵט|lehilaket
לְלַקֵּט|lelaket
יַלְקוּט|yalkut
לִלְקוֹט|lilkot
לֶקֶט|leket
לְהַלְקוֹת|lehalkot
לִלְקוֹת|lilkot
לָקוּי|lakuy
לִיקּוּי|likuy
לְלַקֵּק|lelakek
לִקְרַאת|likrat
לְרוֹחַב|lerochav
לִשְׁכָּה|lishka
הַלְשָׁנָה|halshana
לָשׁוֹן|lashon
בַּלְשָׁן|balshan
לְהַלְשִׁין|lehalshin
מֵאָה|me'a
מְאוֹד|me'od
מֵאָז|me'az
מְאַייִן|me'ayin
לְמָאֵן|lema'en
לְהִימָּאֵס|lehima'es
לְהַמְאִיס|leham'is
לִמְאוֹס|lim'os
מֵאֲשֶׁר|me'asher
מָאתַייִם|matayim
מְגַמָּה|megama
לְמַגֵּן|lemagen
לְמַגְנֵט|lemagnet
לְהִתְמַגְנֵט|lehitmagnet
מַגָּף|magaf
לְמַגֵּר|lemager
מַמְגּוּרָה|mamgura
לָמוֹד|lamod
לְהִימָּדֵד|lehimaded
מִידָּה|mida
מְדִידָה|medida
מַדָּד|madad
לְהִתְמוֹדֵד|lehitmoded
מֵימַד|memad
מַדּוּעַ|madua
מְדִינִיּוּת|mediniyut
מִידּוּר|midur
מִדְרוֹן|midron
מִדְרוֹנִי|midroni
מַה|ma
מַהוּת|mahut
מַהוּתִי|mahuti
לִמְהוֹל|limhol
לְהִימָּהֵל|lehimahel
לְהִתְמַהְמֵהַּ|lehitmahmeah
לְמַהֵר|lemaher
מָהִיר|mahir
מְהִירוּת|mehirut
לְהִימּוֹג|lehimog
לְהִתְמוֹגֵג|lehitmogeg
מוֹדֶרְנִי|moderni
מוּזֵיאוֹן|muze'on
מוּזִיקָה|muzika
לְמוֹטֵט|lemotet
לְהִתְמוֹטֵט|lehitmotet
לָמוּט|lamut
לְהִימּוֹט|lehimot
מוֹט|mot
לָמוּל|lamul
לְהִימּוֹל|lehimol
מוּל|mul
מוּסְלְמִי|muslemi
לְהָמִיר|lehamir
תְּמוּרָה|tmura
לָמוּשׁ|lamush
לָמוּת|lamut
לְהָמִית|lehamit
מָווֶת|mavet
תְּמוּתָה|tmuta
לִמְזוֹג|limzog
לְהִתְמַזֵּג|lehitmazeg
מֶזֶג|mezeg
מַזְגָן|mazgan
לְמַזֵּג|lemazeg
לְמַזֵּג|lemazeg
מַזָּל|mazal
לְהִתְמַזֵּל|lehitmazel
לְהִתְמַזְמֵז|lehitmazmez
לְמַזְמֵז|lemazmez
לְמַזְעֵר|lemaz'er
לִמְחוֹא|limcho
מְחָאָה|mecha'a
לְהַמְחִיז|lehamchiz
לְמַחְזֵר|lemachzer
מוֹחַ|moach
לִמְחוֹט|limchot
מִמְחָטָה|mimchata
לִמְחוֹת|limchot
לְהִימָּחוֹת|lehimachot
לְהִתְמַחוֹת|lehitmachot
לְמַחוֹת|lemachot
מוּמְחֶה|mumche
הִתְמַחוּת|hitmachut
מִתְמַחֶה|mitmache
לִמְחוֹל|limchol
מְחִילָה|mechila
לִמְחוֹץ|limchotz
לְהִימָּחֵץ|lehimachetz
לִמְחוֹק|limchok
לְהִימָּחֵק|lehimachek
מְחִיקָה|mechika
מָחִיק|machik
מָחָר|machar
מְחִיר|mechir
מְחִירוֹן|mechiron
מָחֳרָתַייִם|mochoratayim
לְהַמְחִישׁ|lehamchish
לְמַחְשֵׁב|lemachshev
לְהַמְטִיר|lehamtir
מַמְטֵרָה|mamtera
מָטָר|matar
מִטְרִייָּה|mitriya
מִי|mi
מַיִם|mayim
מֵימָן|meiman
מִיּוּן|miyun
מִין|min
תְּמוּנָה|tmuna
מִין|min
לְמַייֵּן|lemayen
מִיקְרוֹגַל|mikrogal
לְהָמִישׁ|lehamish
מִישֶׁהוּ|mishehu
מִישֶׁהִי|mishehi
לִמְכּוֹר|limkor
לְהִתְמַכֵּר|lehitmaker
לְהִימָּכֵר|lehimacher
מְכִירָה|mechira
מָכוּר|machur
הִתְמַכְּרוּת|hitmakrut
מֶכֶר|mecher
לְהִתְמַלֵּא|lehitmale
לִמְלֹאת|limlot
מָלֵא|male
לְמַלֵּא|lemale
מְלָאכָה|melacha
מִלְגָּה|milga
מֶלוֹן|melon
מֶלַח|melach
מָלוּחַ|maluach
לְהַמְלִיחַ|lehamliach
לְמַלֵּט|lemalet
לְהִימָּלֵט|lehimalet
לְהַמְלִיט|lehamlit
מִילּוּט|milut
מְלִיטָה|melita
מֶלֶט|melet
מֶלֶךְ|melech
מַמְלָכָה|mamlacha
לְהַמְלִיךְ|lehamlich
מַמְלַכְתִּי|mamlachti
מַלְכָּה|malka
מַלְכוּת|malchut
מַמְלַכְתִּיּוּת|mamlachtiyut
לִמְלוֹךְ|limloch
מְלוּכָה|melucha
לְמַלְכֵּד|lemalked
מִלְּכַתְּחִילָּה|milechatchila
לְמַלֵּל|lemalel
מֶלֶל|melel
מִילָּה|mila
מִילּוֹן|milon
לְמַלְמֵל|lemalmel
מְלָפְפוֹן|melafefon
לְהַמְלִיץ|lehamlitz
הַמְלָצָה|hamlatza
מֶלְצַר|meltzar
לִמְלוֹק|limlok
לְמַמֵּן|lemamen
מִימּוּן|mimun
לְמַמֵּשׁ|lemamesh
לְהִתְמַמֵּשׁ|lehitmamesh
מִימּוּשׁ|mimush
מַמָּשׁ|mamash
מַמָּשׁ|mamash
מַמָּשִׁי|mamashi
מַמָּשִׁיּוּת|mamashiyut
מִן|min
מַנְגִּינָה|mangina
מַנְגָּנוֹן|manganon
מִנְחָה|mincha
לִמְנוֹת|limnot
לְהִימָּנוֹת|lehimanot
לְמַנּוֹת|lemanot
מְנָיָה|menaya
מָנוּי|manuy
מִינּוּי|minuy
מָנָה|mana
לְהִתְמַנּוֹת|lehitmanot
לְמַנֵּן|lemanen
לִמְנוֹעַ|limnoa
לְהִימָּנֵעַ|lehimanea
מְנִיעָה|meni'a
לְמַנֵּף|lemanef
לְמַסְגֵּר|lemasger
לְמַסֵּד|lemased
מִמְסָד|mimsad
לְהִתְמַסֵּד|lehitmased
מִיסְחוּר|mischur
לְהִתְמַסְחֵר|lehitmascher
לְמַסְחֵר|lemascher
לְהִתְמַסְטֵל|lehitmastel
לְמַסּוֹת|lemasot
מִיסּוּי|misuy
מִסְכֵּן|misken
לְהִתְמַסְמֵס|lehitmasmes
לְמַסְמֵר|lemasmer
לְהִתְמוֹסֵס|lehitmoses
מַס|mas
לְהָמִיס|lehamis
תְּמִיסָּה|tmisa
לְהִימּוֹס|lehimos
לְמַסְפֵּר|lemasper
לִמְסוֹר|limsor
לְהִימָּסֵר|lehimaser
לְהִתְמַסֵּר|lehitmaser
מֶסֶר|meser
מָסוֹרֶת|masoret
מָסוֹרְתִּי|masorti
מָסוּר|masur
מְסִירוּת|mesirut
לְמַסְרֵר|lemasrer
לִמְעוֹד|lim'od
לְהַמְעִיד|leham'id
לְמַעֵט|lema'et
לְהַמְעִיט|leham'it
לְהִתְמַעֵט|lehitma'et
מָעַט|ma'at
מְעַט|me'at
מוּעָט|mu'at
מְעִי|me'i
לִמְעוֹךְ|lim'och
לְהִימָּעֵךְ|lehima'ech
מְעִיל|me'il
לִמְעוֹל|lim'ol
מֵעַל|me'al
לְמַעֵן|lema'en
מַעַן|ma'an
לִמְעוֹן|lim'on
מֵעַתָּה|me'ata
מַפָּה|mapa
לְמַפּוֹת|lemapot
מִפְּנֵי|mipnei
מוֹפֵת|mofet
לִמְצוֹא|limtzo
לְהִימָּצֵא|lehimatze
לְהַמְצִיא|lehamtzi
הִתְמַצְּאוּת|hitmatz'ut
הִימָּצְאוּת|himatz'ut
הַמְצָאָה|hamtza'a
מְצִיאוּת|metzi'ut
לְהִתְמַצֵּא|lehitmatze
מְצִיאָה|metzi'a
מִיצּוּב|mitzuv
לְמַצֵּב|lematzev
מֵצַח|metzach
לְמַצּוֹת|lematzot
לִמְצוֹת|limtzot
מָצוּי|matzuy
תַּמְצִית|tamtzit
מִיץ|mitz
לְמַצְמֵץ|lematzmetz
אֶמְצָעוּת|emtza'ut
אֶמְצַע|emtza
לִמְצוֹץ|limtzotz
לְהִימָּצֵץ|lehimatzetz
מְצִיצָה|metzitza
לְהִתְמַצֵּק|lehitmatzek
מִצְרִי|mitzri
מִצְרַייִם|mitzrayim
לְמַקֵּד|lemaked
לְהִתְמַקֵּד|lehitmaked
מִיקּוּד|mikud
מִיקּוּד|mikud
לְהִתְמַקֵּחַ|lehitmakeach
מִקְטוֹרֶן|miktoren
לְמַקֵּם|lemakem
לְהִתְמַקֵּם|lehitmakem
מִיקּוּם|mikum
לְמַקְסֵס|lemakses
לְמַקֵּף|lemakef
לְהִתְמַקְצֵעַ|lehitmaktzea
לְהִימֵּק|lehimek
לְמַקֵּשׁ|lemakesh
מַר|mar
לְהַמְרִיא|lehamri
הַמְרָאָה|hamra'a
לִמְרוֹד|limrod
לְהִתְמָרֵד|lehitmared
מֶרֶד|mered
מַרְדָן|mardan
לִמְרוֹחַ|limroach
לְהִימָּרֵחַ|lehimareach
לִמְרוֹט|limrot
לְהַמְרוֹת|lehamrot
מָרִית|marit
לְמַרְכֵּז|lemarkez
לְהִתְמַרְכֵּז|lehitmarkez
לְמַרְמֵר|lemarmer
לְהִתְמַרְמֵר|lehitmarmer
לְמַרְפֵּק|lemarpek
לְהַמְרִיץ|lehamritz
הַמְרָצָה|hamratza
מֶרֶץ|meretz
תַּמְרִיץ|tamritz
תַּמְרוּק|tamruk
מָרָק|marak
לְמָרֵק|lemarek
מָרִיר|marir
לְהָמֵר|lehamer
לְמָרֵר|lemarer
מַר|mar
מַשָּׂא|masa
מַשָּׂאִית|masa'it
לְהַמְשִׂיג|lehamsig
מַשֶּׁהוּ|mashehu
מְשׁוּפְשָׁף|meshufshaf
לִמְשׁוֹחַ|limshoach
מִשְׁחָה|mishcha
מָשִׁיחַ|mashiach
לִמְשׁוֹת|limshot
לְהִימָּשׁוֹת|lehimashot
מְשִׁיכָה|meshicha
לִמְשׁוֹךְ|limshoch
לְהִימָּשֵׁךְ|lehimashech
לְהִתְמַשֵּׁךְ|lehitmashech
לְהַמְשִׁיךְ|lehamshich
הֶמְשֵׁךְ|hemshech
מֶשֶׁךְ|meshech
הִימָּשְׁכוּת|himashchut
לְמַשְׁכֵּן|lemashken
לִמְשׁוֹל|limshol
לְהַמְשִׁיל|lehamshil
לְהִימָּשֵׁל|lehimashel
מָשָׁל|mashal
מֶמְשֶׁלֶת|memshelet
מֶמְשַׁלְתִּי|memshalti
מוֹשֵׁל|moshel
לְמַשְׁמֵעַ|lemashmea
לְמַשְׁמֵשׁ|lemashmesh
מֶשֶׁק|meshek
מִמְשָׁק|mimshak
מִשְׁקְפֵי שֵׁמֶשׁ|mishkefeishemesh
לְמַשֵּׁשׁ|lemashesh
לְמַתֵּג|lemateg
מֶתֶג|meteg
לִמְתּוֹחַ|limtoach
לְהִימָּתֵחַ|lehimateach
מְתִיכוּת|metichut
מֶתַח|metach
מֶתַח|metach
מָתוּחַ|matuach
מָתִיחַ|matiach
לְהִתְמַתֵּחַ|lehitmateach
מִתַּחַת|mitachat
מָתַי|matay
מָתֶמָטִיקָה|matematika
לְמַתֵּן|lematen
לְהַמְתִּין|lehamtin
לְהַמְתִּיק|lehamtik
מַמְתָּק|mamtak
מָתוֹק|matok
נָא|na
לִנְאוֹת|lin'ot
לִנְאוֹם|lin'om
נְאוּם|ne'um
לְנָאֵף|lena'ef
לִנְאוֹף|lin'of
נִיאוּף|ni'uf
לְנָאֵץ|lena'etz
לִנְאוֹק|lin'ok
נְאָקָה|ne'aka
לְנַבֵּא|lenabe
לְהִתְנַבֵּא|lehitnabe
לְהִינָּבֵא|lehinave
נְבוּאָה|nevu'a
נָבִיא|navi
לִנְבּוֹחַ|linboach
נַבְחָן|navchan
לְהַנְבִּיט|lehanbit
לְהַבִּיט|lehabit
מַבָּט|mabat
לִנְבּוֹט|linbot
הֶיבֵּט|hebet
לִנְבּוֹל|linbol
נָבָל|naval
לִנְבּוֹעַ|linboa
לְהַבִּיעַ|lehabia
הַבָּעָה|haba'a
לִנְבּוֹר|linbor
לְנַגֵּב|lenagev
לְהִתְנַגֵּב|lehitnagev
מַגֶּבֶת|magevet
מַגֵּב|magev
מַגְּבוֹן|magvon
לְהַנְגִּיד|lehangid
נַגָּד|nagad
לְהִתְנַגֵּד|lehitnaged
הִתְנַגְּדוּת|hitnagdut
מְנוּגָּד|menugad
אַגָּדָה|agada
נֶגֶד|neged
הַגָּדָה|hagada
לְהַגִּיד|lehagid
לִנְגּוֹד|lingod
לִנְגּוֹהַּ|lingoah
לְהַגִּיהַּ|lehagiah
נוֹגַהּ|nogah
לִנְגּוֹחַ|lingoach
נַגָּח|nagach
לְנַגֵּן|lenagen
נִיגּוּן|nigun
לְהִתְנַגֵּן|lehitnagen
לִנְגּוֹס|lingos
מַגָּע|maga
לְהַגִּיעַ|lehagia
לָגַעַת|laga'at
לְנַגֵּעַ|lenagea
נֶגַע|nega
נָגוּעַ|nagua
הַגָּעָה|haga'a
לְהִינָּגַע|lehinaga
לְהִינָּגֵף|lehinagef
לְהִינָּגֵר|lehinager
נַגָּר|nagar
לְנַגֵּר|lenager
לָגֶשֶׁת|lageshet
לְהַגִּישׁ|lehagish
לְהַנְגִּישׁ|lehangish
הִתְנַגְּשׁוּת|hitnagshut
נָגִישׁ|nagish
לְהִתְנַגֵּשׁ|lehitnagesh
גִּישָׁה|gisha
מַגָּשׁ|magash
לְנַדֵּב|lenadev
לְהִתְנַדֵּב|lehitnadev
נְדָבָה|nedava
הִתְנַדְּבוּת|hitnadvut
נָדִיב|nadiv
נְדִיבוּת|nedivut
לִנְדּוֹב|lindov
לִנְדּוֹד|lindod
הַדָּחָה|hadacha
לְהַדִּיחַ|lehadiach
לְנַדּוֹת|lenadot
לְנַדְנֵד|lenadned
לְהִתְנַדְנֵד|lehitnadned
לְהִתְנַדֵּף|lehitnadef
מַדָּף|madaf
לְהִינָּדֵף|lehinadef
לְהַדִּיף|lehadif
לִידּוֹר|lidor
נֶדֶר|neder
נָדִיר|nadir
לְהַדִּיר|lehadir
לְהִתְנַהֵג|lehitnaheg
לִנְהוֹג|linhog
לְהַנְהִיג|lehanhig
נֶהָג|nehag
הִתְנַהֲגוּת|hitnahagut
נְהִיגָה|nehiga
מִנְהָג|minhag
נָהוּג|nahug
מַנְהִיג|manhig
לְנַהֵל|lenahel
מִנְהָל|minhal
מְנַהֵל|menahel
נוֹהַל|nohal
לְהִתְנַהֵל|lehitnahel
לִנְהוֹם|linhom
לִנְהוֹק|linhok
לִנְהוֹר|linhor
נָהָר|nahar
מִנְהָרָה|minhara
לְהָנִיא|lehani
לְהָנִיב|lehaniv
לָנוּב|lanuv
תְּנוּבָה|tnuva
לָנוּד|lanud
לְהִתְנוֹדֵד|lehitnoded
לְהָנִיד|lehanid
תְּנוּדָה|tnuda
לָנוּחַ|lanuach
לְהָנִיחַ|lehaniach
לְהַנִּיחַ|lehaniach
תְּנוּחָה|tnucha
מְנוּחָה|menucha
נַחַת|nachat
נוֹחַ|noach
נוֹחוּת|nochut
לְנַווֵּט|lenavet
נַווָּט|navat
נָאווֶה|nave
לִנְווֹת|linvot
לָנוּם|lanum
לְהִתְנַווֵּן|lehitnaven
לְנַווֵּן|lenaven
מְנוּוָּן|menuvan
לְהָנִיס|lehanis
לָנוּס|lanus
מָנוֹס|manos
לָנוּעַ|lanua
לְהָנִיעַ|lehania
לְהִתְנוֹעֵעַ|lehitno'ea
תְּנוּעָה|tnu'a
מָנוֹעַ|manoa
לְנוֹפֵף|lenofef
לְהִתְנוֹפֵף|lehitnofef
לְהָנִיף|lehanif
מָנוֹף|manof
מְנִיפָה|menifa
נוֹף|nof
תְּנוּפָה|tnufa
תַּנּוּר|tanur
נוּר|nur
מְנוֹרָה|menora
נֵר|ner
נוּרָה|nura
לְהַזּוֹת|lehazot
לְהַנְזִיל|lehanzil
לִנְזוֹל|linzol
לְהַזִּיל|lehazil
נַזֶּלֶת|nazelet
נוֹזְלִי|nozli
נוֹזֵל|nozel
לְהִינָּזֵף|lehinazef
לִנְזוֹף|linzof
לְהַזִּיק|lehazik
לְהִינָּזֵק|lehinazek
נֶזֶק|nezek
לְהִתְנַזֵּר|lehitnazer
לְהַנְחוֹת|lehanchot
הַנְחָיָה|hanchaya
לִנְחוֹל|linchol
לְהַנְחִיל|lehanchil
לְהִתְנַחֵל|lehitnachel
נַחֲלָה|nachala
לְנַחֵם|lenachem
לְהִינָּחֵם|lehinachem
נֶחָמָה|nechama
לְהִתְנַחֵם|lehitnachem
לְהִתְנַחְמֵד|lehitnachmed
נָחוּץ|nachutz
לִנְחוֹר|linchor
נְחִיר|nechir
לְנַחֵשׁ|lenachesh
נָחָשׁ|nachash
נְחוֹשֶׁת|nechoshet
לִנְחוֹת|linchot
נֶחָת|nechat
לְהַנְחִית|lehanchit
לִנְטוֹת|lintot
לְהַטּוֹת|lehatot
לְהִינָּטוֹת|lehinatot
לְמַטָּה|lemata
מִיטָּה|mita
נְטִייָּה|netiya
מַטָּלָה|matala
לִיטּוֹל|litol
לְהִינָּטֵעַ|lehinatea
לָטַעַת|lata'at
לִנְטוֹף|lintof
לְהַטִּיף|lehatif
לִנְטוֹר|lintor
מַטָּרָה|matara
לְנַטֵּר|lenater
נִיטּוּר|nitur
לְנַטְרֵל|lenatrel
לִנְטוֹשׁ|lintosh
לְהִינָּטֵשׁ|lehinatesh
לְהִינָּטֵשׁ|lehinatesh
נָטוּשׁ|natush
נַייָּד|nayad
נַייָּד|nayad
נַייֶּדֶת|nayedet
לְהִתְנַייֵּד|lehitnayed
נִיחוֹחַ|nichoach
נְייָר|neyar
נִין|nin
נִינָה|nina
נִירוֹסְטָה|nirosta
נֶכֶד|neched
נֶכְדָּה|nechda
לִנְכּוֹחַ|linkoach
לְהַנְכִיחַ|lehanchiach
נוֹכֵחַ|nocheach
נוֹכְחוּת|nochechut
לְהַכּוֹת|lehakot
לְנַכּוֹת|lenakot
נָכֶה|nache
נָכוּת|nachut
מַכָּה|maka
נִיכּוּי|nikuy
לְהִתְנַכֵּל|lehitnakel
נוֹכֵל|nochel
נֶכֶס|neches
הַכָּרָה|hakara
לְהִינָּכֵר|lehinacher
לְנַכֵּר|lenaker
נַר|nar
לְהַכִּיר|lehakir
לְהִתְנַכֵּר|lehitnaker
הֶיכֵּר|heker
לְהַכִּישׁ|lehakish
מַכּוֹשׁ|makosh
לְהַנְמִיךְ|lehanmich
הַנְמָכָה|hanmacha
נָמוּךְ|namuch
נָמֵל|namel
לְנַמְנֵם|lenamnem
לְהִתְנַמְנֵם|lehitnamnem
מְנוּמָּס|menumas
נִימּוּס|nimus
לְנַמֵּק|lenamek
נִימּוּק|nimuk
נָמֵר|namer
נְסִיגָה|nesiga
לְהַסִּיג|lehasig
לְהַסִּיחַ|lehasiach
נוּסְחָה|nuscha
לְנַסֵּחַ|lenaseach
לְנַסּוֹת|lenasot
נִיסָּיוֹן|nisayon
נִיסּוּי|nisuy
לְהִתְנַסּוֹת|lehitnasot
נְסִיכָה|nesicha
נָסִיךְ|nasich
לִנְסוֹךְ|linsoch
מַסֵּכָה|masecha
נֵס|nes
לְהִתְנוֹסֵס|lehitnoses
נְסִיעָה|nesi'a
מַסָּע|masa
מַסּוֹעַ|masoa
לִנְסוֹעַ|linsoa
לְהַסִּיעַ|lehasia
הַסָּעָה|hasa'a
לְהַסִּיק|lehasik
לְהַסִּיק|lehasik
לִנְסוֹק|linsok
מַסּוֹק|masok
מַסְּקָנָה|maskana
לְנַסֵּר|lenaser
נְסוֹרֶת|nesoret
מַסּוֹר|masor
לִנְסוֹר|linsor
לִנְעוֹל|lin'ol
לִנְעוֹל|lin'ol
תִּנְעוֹלֶת|tin'olet
לְהַנְעִיל|lehan'il
נַעַל|na'al
נְעִילָה|ne'ila
לְהִינָּעֵל|lehina'el
מַנְעוּל|man'ul
לִנְעוֹם|lin'om
לְהַנְעִים|lehan'im
נָעִים|na'im
נְעִימָה|ne'ima
לְנַעְנֵעַ|lena'anea
לְהִתְנַעְנֵעַ|lehitna'anea
לִנְעוֹץ|lin'otz
נָעוּץ|na'utz
לְהִינָּעֵץ|lehina'etz
נְעוּרִים|ne'urim
לְנַעֵר|lena'er
לְהִתְנַעֵר|lehitna'er
לְהִינָּעֵר|lehina'er
לִנְעוֹר|lin'or
נַעַר|na'ar
נַעֲרָה|na'ara
לִנְפּוֹחַ|linpoach
לְנַפֵּחַ|lenapeach
לְהִתְנַפֵּחַ|lehitnapeach
נַפָּח|napach
תַּפּוּחַ|tapuach
לְנַפּוֹת|lenapot
לְהַפִּיל|lehapil
לִיפּוֹל|lipol
הַפָּלָה|hapala
לְהִתְנַפֵּל|lehitnapel
לְנַפְנֵף|lenafnef
לְנַפֵּץ|lenapetz
לְהִתְנַפֵּץ|lehitnapetz
נִיפּוּץ|niputz
נַפָּץ|napatz
לְהַנְפִּיק|lehanpik
לְהַפִּיק|lehapik
לְהַנְפִּישׁ|lehanpish
נֶפֶשׁ|nefesh
לִנְפּוֹשׁ|linposh
נְצִיב|netziv
נָצִיג|natzig
נְצִיגוּת|netzigut
לְנַצֵּחַ|lenatzeach
לְהִתְנַצֵּחַ|lehitnatzeach
לְהַנְצִיחַ|lehantziach
הַנְצָחָה|hantzacha
נִיצּוּחַ|nitzuach
נִיצָּחוֹן|nitzachon
מְנַצֵּחַ|menatzeach
נֶצַח|netzach
נִצְחִי|nitzchi
הַצָּלָה|hatzala
לְהַצִּיל|lehatzil
לְהִינָּצֵל|lehinatzel
לְנַצֵּל|lenatzel
לְהִתְנַצֵּל|lehitnatzel
נִיצּוּל|nitzul
נַצְלָן|natzlan
נִיצּוֹלֶת|nitzolet
הִתְנַצְּלוּת|hitnatzlut
הִינָּצְלוּת|hinatzlut
לְנַצְנֵץ|lenatznetz
לְהִתְנוֹצֵץ|lehitnotzetz
לְהָנֵץ|lehanetz
לִנְצוֹץ|lintzotz
הָנֵץ|hanetz
נִיצָּן|nitzan
נִיצוֹץ|nitzotz
לְהִתְנַצֵּר|lehitnatzer
הִתְנַצְּרוּת|hitnatzrut
נוֹצְרִי|notzri
נַצְרוּת|natzrut
לִנְצוֹר|lintzor
לִנְקוֹב|linkov
נְקֵבָה|nekeva
מַנְקֵב|mankev
נִיקּוּד|nikud
נְקוּדָּה|nekuda
לְנַקֵּד|lenaked
לְהִתְנַקֵּז|lehitnakez
לְנַקֵּז|lenakez
נִיקּוּז|nikuz
לְהִינָּקֵט|lehinaket
לִנְקוֹט|linkot
לְנַקּוֹת|lenakot
נִיקּוּי|nikuy
נִיקָּיוֹן|nikayon
לְהִתְנַקּוֹת|lehitnakot
נָקִי|naki
מַקֵּל|makel
לִנְקוֹם|linkom
נְקָמָה|nekama
לְהִתְנַקֵּם|lehitnakem
לְהִינָּקֵם|lehinakem
נַקְנִיק|naknik
לִנְקוֹעַ|linkoa
לְהַקִּיף|lehakif
מַקָּף|makaf
לִנְקוֹף|linkof
מַקּוֹר|makor
לְנַקֵּר|lenaker
נַקָּר|nakar
לִנְקוֹשׁ|linkosh
לְהִתְנַקֵּשׁ|lehitnakesh
לְהַקִּישׁ|lehakish
מַקָּשׁ|makash
נָשׂוּי|nasuy
לְהִתְנַשֵּׂא|lehitnase
לָשֵׂאת|laset
לְהִינָּשֵׂא|lehinase
לְהַשִּׂיא|lehasi
נָשִׂיא|nasi
שִׂיא|si
תְּשׂוּאָה|tsu'a
מוּשָּׂא|musa
נוֹשֵׂא|nose
מִתְנַשֵּׂא|mitnase
לְנַשֵּׁב|lenashev
לִנְשׁוֹב|linshov
לְהַשִּׂיג|lehasig
מוּשָּׂג|musag
הֶישֵּׂג|heseg
לְנַשֵּׁךְ|lenashech
לִנְשׁוֹךְ|linshoch
לְהִינָּשֵׁךְ|lehinashech
לְנַשֵּׁל|lenashel
לִנְשׁוֹל|linshol
לְהַשִּׁיל|lehashil
לִנְשׁוֹם|linshom
לְהִתְנַשֵּׁם|lehitnashem
נְשָׁמָה|neshama
לְהַנְשִׁים|lehanshim
הַנְשָׁמָה|hanshama
לְנַשְׁנֵשׁ|lenashnesh
לִנְשׁוֹף|linshof
לְהִתְנַשֵּׁף|lehitnashef
נֶשֶׁף|neshef
לְנַשֵּׁף|lenashef
יַנְשׁוּף|yanshuf
לְנַשֵּׁק|lenashek
לְהַשִּׁיק|lehashik
לְהִתְנַשֵּׁק|lehitnashek
מַשִּׁיק|mashik
נְשִׁיקָה|neshika
נֵשֶׁק|neshek
לִנְשׁוֹק|linshok
הַשָּׁקָה|hashaka
לִנְשׁוֹר|linshor
לְהַנְשִׁיר|lehanshir
נֶשֶׁר|nesher
לְהַשִּׁיר|lehashir
מִנְשָׁר|minshar
קַרְקָעִי|karka'i
לְנַתֵּב|lenatev
נָתִיב|nativ
לְהַתִּיז|lehatiz
לְהִינָּתֵז|lehinatez
לְנַתֵּחַ|lenateach
נִיתּוּחַ|nituach
מַתֶּכֶת|matechet
לְהַתִּיךְ|lehatich
לָתֵת|latet
לְהִינָּתֵן|lehinaten
נָתוּן|natun
נְתוּנִים|netunim
מַתָּנָה|matana
לְנַתֵּץ|lenatetz
לְהַתִּיק|lehatik
לְהִינָּתֵק|lehinatek
הִינָּתְקוּת|hinatkut
לְהִתְנַתֵּק|lehitnatek
לְנַתֵּק|lenatek
נִיתּוּק|nituk
נֶתֶק|netek
מוּתָּר|mutar
לְנַתֵּר|lenater
לְהַתִּיר|lehatir
לְהַתִּישׁ|lehatish
הַתָּשָׁה|hatasha
לְהִסְתָּאֵב|lehista'ev
לִסְאוֹן|lis'on
סַבָּא|saba
לְהִסְתּוֹבֵב|lehistovev
לְהִיסּוֹב|lehisov
לְסוֹבֵב|lesovev
לָסוֹב|lasov
לְסַבֵּב|lesabev
סֵבֶב|sevev
סְבִיבָה|sviva
מְסִיבָּה|mesiba
סִיבָּה|siba
לְהָסֵב|lehasev
סָבִיב|saviv
סְבִיבוֹן|svivon
סַבּוֹן|sabon
לְסַבֵּךְ|lesabech
תִּסְבּוֹכֶת|tisbochet
סָבוּךְ|savuch
לְהִסְתַּבֵּךְ|lehistabech
לִסְבּוֹל|lisbol
סֵבֶל|sevel
סַבָּל|sabal
סַבְלָן|savlan
סַבְלָנוּת|savlanut
לְסַבְּלֵט|lesablet
לְסַבֵּן|lesaben
לְהִסְתַּבֵּן|lehistaben
לְסַבְסֵד|lesavsed
סָבוּר|savur
לְהַסְבִּיר|lehasbir
סְבָרָה|svara
הֶסְבֵּר|hesber
הַסְבָּרָה|hasbara
הִסְתַּבְּרוּת|histabrut
לִסְבּוֹר|lisbor
לְהִסְתַּבֵּר|lehistaber
סָבִיר|savir
סָבְתָא|savta
מִסְגָּד|misgad
לִסְגּוֹד|lisgod
לְסַגֵּל|lesagel
הִסְתַּגְּלוּת|histaglut
מְסוּגָּל|mesugal
סָגוֹל|sagol
לְהִסְתַּגֵּל|lehistagel
סְגוּלָּה|sgula
סְגָן|sgan
סִגְנוֹן|signon
לְסַגְנֵן|lesagnen
סִיגְנוּן|signun
לְסַגְסֵג|lesagseg
סַגְסוֹגֶת|sagsoget
לְהִסְתַּגֵּף|lehistagef
לְסַגֵּף|lesagef
הַסְגָּרָה|hasgara
לִסְגּוֹר|lisgor
לְהִיסָּגֵר|lehisager
לְהַסְגִּיר|lehasgir
סְגִירָה|sgira
מִסְגֶּרֶת|misgeret
מַסְגֵּר|masger
סָגוּר|sagur
לְהִסְתַּגֵּר|lehistager
הֶסְגֵּר|hesger
סַדְנָה|sadna
סַדָּן|sadan
לְהִיסָּדֵק|lehisadek
לְסַדֵּק|lesadek
סֶדֶק|sedek
לִסְדּוֹק|lisdok
מִסְדְּרוֹן|misderon
לְסַדֵּר|lesader
לְהַסְדִּיר|lehasdir
סֵדֶר|seder
סִדְרָה|sidra
סַדָּר|sadar
סַדְרָן|sadran
סְדָר|sdar
סִידּוּרִי|siduri
לְהִסְתַּדֵּר|lehistader
סִידּוּר|sidur
סַהַר|sahar
סוֹהֵר|soher
סוֹהַר|sohar
סַהֲרוֹן|saharon
לָסֶגֶת|laseget
לְסַווֵּג|lesaveg
סוּג|sug
סוֹד|sod
לְהִסְתּוֹדֵד|lehistoded
סְווֶדֶר|sveder
לְהַסְווֹת|lehasvot
סוּס|sus
סוּסָה|susa
סוֹף|sof
סוֹפִי|sofi
סוּפָה|sufa
לָסוּר|lasur
לְהָסִית|lehasit
לִסְחוֹב|lischov
לְהִיסָּחֵב|lehisachev
לִסְחוֹט|lischot
לְהִיסָּחֵט|lehisachet
מַסְחֵטָה|mascheta
לִסְחוֹף|lischof
לְהִיסָּחֵף|lehisachef
סְחוֹפֶת|schofet
לִסְחוֹר|lischor
מִסְחָר|mischar
סְחוֹרָה|schora
סַחַר|sachar
סוֹחֵר|socher
לְסַחְרֵר|lesachrer
לְהִסְתַּחְרֵר|lehistachrer
סִיחְרוּר|sichrur
סְטוּדֶנְט|student
לִסְטוֹת|listot
סְטִירָה|stira
לִסְטוֹר|listor
סִיב|siv
לְהִסְתַּייֵּג|lehistayeg
לְסַייֵּג|lesayeg
הִסְתַּייְּגוּת|histaygut
לְסַייֵּד|lesayed
לְהָסִיחַ|lehasiach
לָסִיחַ|lasiach
לְהָסִיט|lehasit
לְהִסְתַּייֵּם|lehistayem
סִיּוּם|siyum
סִיּוֹמֶת|siyomet
לְסַייֵּם|lesayem
סִיס|sis
לְסַייֵּעַ|lesayea
לְהִסְתַּייֵּעַ|lehistayea
סַייְעָן|say'an
סִיּוּעַ|siyua
סִיפוֹן|sifon
לְהָסִיר|lehasir
לְסַייֵּר|lesayer
סַייֶּרֶת|sayeret
סִיּוּר|siyur
סִיר|sir
סָךְ|sach
לִסְכּוֹךְ|liskoch
לְסוֹכֵךְ|lesochech
לְסַכֵּךְ|lesakech
מָסַךְ|masach
מוּסָךְ|musach
לְסַכֵּל|lesakel
סִיכּוּל|sikul
לְהִסְתַּכֵּל|lehistakel
הֶסְכֵּם|heskem
לְסַכֵּם|lesakem
לְהַסְכִּים|lehaskim
סִיכּוּם|sikum
סְכוּם|schum
לִסְכּוֹם|liskom
לְהִסְתַּכֵּם|lehistakem
הַסְכָּמָה|haskama
מְסוּכָּן|mesukan
לְסַכֵּן|lesaken
סִיכּוּן|sikun
סַכָּנָה|sakana
סוֹכֵן|sochen
סוֹכְנוּת|sochnut
לְהַסְכִּין|lehaskin
לְהִסְתַּכֵּן|lehistaken
סַכִּין|sakin
סִיכְסוּךְ|sichsuch
לְהִסְתַּכְסֵךְ|lehistachsech
לְסַכְסֵךְ|lesachsech
לִסְכּוֹר|liskor
סֶכֶר|secher
לְהַסְכִּית|lehaskit
הֶסְכֵּת|hesket
תַּסְכִּית|taskit
סַל|sal
לִסְלוֹד|lislod
סָלוֹן|salon
לִסְלוֹחַ|lisloach
לְהִיסָּלֵחַ|lehisaleach
סְלִיחָה|slicha
סָלָט|salat
סוֹלְלָה|solela
לְהִיסָּלֵל|lehisalel
לִסְלוֹל|lislol
מְסִילָּה|mesila
מַסְלוּל|maslul
הַסְלָמָה|haslama
לְהַסְלִים|lehaslim
סוּלָּם|sulam
לְהִסְתַּלְסֵל|lehistalsel
לְסַלְסֵל|lesalsel
סֶלַע|sela
לְסַלֵּף|lesalef
סִילּוּף|siluf
לְסַלֵּק|lesalek
לְהִסְתַּלֵּק|lehistalek
סִילּוּק|siluk
לְסַמֵּא|lesame
לְהִסְתַּמֵּא|lehistame
סָמוּי|samuy
לִסְמוֹךְ|lismoch
הַסְמָכָה|hasmacha
מִסְמָךְ|mismach
סָמִיךְ|samich
סָמוּךְ|samuch
סְמִיכָה|smicha
סַמְכוּת|samchut
לְהַסְמִיךְ|lehasmich
לְהִסְתַּמֵּךְ|lehistamech
לְסַמֵּל|lesamel
סֵמֶל|semel
סַמָּל|samal
לְסַמֵּם|lesamem
לְסַמֵּן|lesamen
לְהִסְתַּמֵּן|lehistamen
תִּסְמוֹנֶת|tismonet
סִימּוּן|simun
לְסַמֵּס|lesames
לְסַמְפֵּט|lesampet
לְהַסְמִיק|lehasmik
לִסְמוֹר|lismor
מַסְמֵר|masmer
לְסַמֵּר|lesamer
לְסַמְרֵר|lesamrer
לְסַנְגֵּר|lesanger
לְסַנְדֵּל|lesandel
לְהִסְתַּנְווֵר|lehistanver
סַנְווֵרִים|sanverim
לְסַנְווֵר|lesanver
לְהִסְתַּנְווֵר|lehistanver
סִינְווּר|sinvur
הִסְתַּנְווְרוּת|histanverut
סַנְטֵר|santer
לְסַנְכְּרֵן|lesankren
לְהִסְתַּנְכְּרֵן|lehistankren
סִינְכְּרוּן|sinkrun
לְסַנֵּן|lesanen
לְהִסְתַּנֵּן|lehistanen
מַסְנֵן|masnen
הִסְתַּנְּנוּת|histanenut
סִינּוּן|sinun
מְסוּנָּן|mesunan
תַּסְנִין|tasnin
מִסְנֶנֶת|misnenet
לְסַנֵּף|lesanef
לְהִסְתַּנֵּף|lehistanef
סְנִיף|snif
לִסְעוֹד|lis'od
מִסְעָדָה|mis'ada
סְעוּדָה|se'uda
סִיעוּד|si'ud
לְהִסְתַּעֵף|lehista'ef
לְהִיסָּעֵר|lehisa'er
לְהִסְתַּעֵר|lehista'er
לְהַסְעִיר|lehas'ir
סְעָרָה|se'ara
לִסְעוֹר|lis'or
מִסְפּוֹא|mispo
לִסְפּוֹג|lispog
לְהִיסָּפֵג|lehisafeg
לִסְפּוֹד|lispod
לְהִיסָּפֵד|lehisafed
לְהַסְפִּיד|lehaspid
סַפָּה|sapa
לְסַפֵּחַ|lesapeach
לְהִיסָּפֵחַ|lehisafeach
לִסְפּוֹחַ|lispoach
לְהִסְתַּפֵּחַ|lehistapeach
סִיפּוּחַ|sipuach
לִסְפּוֹת|lispot
לְהִיסָּפוֹת|lehisafot
סֵפֶל|sefel
סֵפֶל|sefel
סִפְנָה|sifna
סַפָּן|sapan
לִסְפּוֹן|lispon
סְפִינָה|sfina
סִיפּוּן|sipun
סַפְסָל|safsal
לְסַפְסֵר|lesafser
סַפְסָר|safsar
סַף|saf
סְפִיקָה|sfika
לְסַפֵּק|lesapek
סְפִיקָה|sfika
לְהִסְתַּפֵּק|lehistapek
לְהַסְפִּיק|lehaspik
לִסְפּוֹק|lispok
סַפָּק|sapak
סָפֵק|safek
הַסְפָּקָה|haspaka
אַסְפָּקָה|aspaka
לִסְפּוֹר|lispor
לְהִסְתַּפֵּר|lehistaper
סִפְרִייָּה|sifriya
סֵפֶר|sefer
סַפָּר|sapar
סִיפּוּר|sipur
סִפְרָה|sifra
תִּסְפּוֹרֶת|tisporet
מִסְפָּרָה|mispara
מִסְפָּר|mispar
לְהִיסָּפֵר|lehisafer
סִפְרוּת|sifrut
סִפְרוּתִי|sifruti
סְפִירָה|sfira
לְסַפֵּר|lesaper
מִסְפָּרַייִם|misparayim
סָפוּר|safur
סְפָרַד|sfarad
סְפָרַדִּי|sfaradi
לְסַפְרֵת|lesafret
סְקִילָה|skila
לִסְקוֹל|liskol
לְסַקֵּל|lesakel
לְהִיסָּקֵל|lehisakel
סַקְרָן|sakran
לִסְקוֹר|liskor
לְסַקֵּר|lesaker
לְהִיסָּקֵר|lehisaker
סֶקֶר|seker
לְסַקְרֵן|lesakren
לְהִסְתַּקְרֵן|lehistakren
לְסָרֵב|lesarev
לְסַרְבֵּל|lesarbel
לִסְרוֹג|lisrog
לְהִיסָּרֵג|lehisareg
סַרְגֵּל|sargel
לְהַסְרִיחַ|lehasriach
סֵירָחוֹן|serachon
לִסְרוֹט|lisrot
לְהִיסָּרֵט|lehisaret
לְהַסְרִיט|lehasrit
הַסְרָטָה|hasrata
סֶרֶט|seret
מַסְרֵטָה|masreta
תַּסְרִיט|tasrit
סֶרֶן|seren
סֶרֶן|seren
לְסָרֵס|lesares
סָרִיס|saris
סַרְעֶפֶת|sar'efet
סְרִיקָה|srika
לְהִיסָּרֵק|lehisarek
לְסָרֵק|lesarek
לְהִסְתָּרֵק|lehistarek
תִּסְרוֹקֶת|tisroket
מַסְרֵק|masrek
לִסְרוֹק|lisrok
סְרָק|srak
סְתָיו|stav
לְהִיסָּתֵם|lehisatem
סָתוּם|satum
לִסְתּוֹם|listom
סְתִימָה|stima
לְהִיסָּתֵר|lehisater
לִסְתּוֹר|listor
לְהִסְתַּתֵּר|lehistater
מִסְתּוֹר|mistor
סְתִירָה|stira
לְהַסְתִּיר|lehastir
נִסְתָּר|nistar
לְסַתֵּת|lesatet
לְעַבֵּד|le'abed
לְהַעֲבִיד|leha'avid
עִיבּוּד|ibud
עֲבוֹדָה|avoda
עֶבֶד|eved
עוּבְדָּה|uvda
עַבְדוּת|avdut
מַעְבָּדָה|ma'abada
לַעֲבוֹד|la'avod
בְּדִיעֲבַד|bedi'avad
עֲבוּר|avur
לְעַבּוֹת|le'abot
לְהִתְעַבּוֹת|lehit'abot
לַעֲבוֹת|la'avot
לְהַעֲבִיר|leha'avir
לְעַבֵּר|le'aber
לְהִתְעַבֵּר|lehit'aber
מַעֲבָר|ma'avar
עֲבַרְייָן|avaryan
עִבְרִי|ivri
לַעֲבוֹר|la'avor
עָבָר|avar
מַעְבּוֹרֶת|ma'aboret
לְעַבְרֵת|le'avret
לְהִתְעַבְרֵת|lehit'avret
לְהִתְעַבֵּשׁ|lehit'abesh
עַגֶּבֶת|agevet
לַעֲגוֹב|la'agov
עָגָה|aga
לְעַגֵּל|le'agel
לְהִתְעַגֵּל|lehit'agel
עִיגּוּל|igul
עָגוֹל|agol
עֲגַלְגַּל|agalgal
לְעַגֵּן|le'agen
עוֹגֶן|ogen
לַעֲגוֹן|la'agon
עִיגּוּן|igun
עַד|ad
עַד|ad
עֲדִי|adi
עֲדַייִן|adayin
לְהִתְעַדְכֵּן|lehit'adken
לְעַדְכֵּן|le'adken
עִידְכּוּן|idkun
לְהִתְעַדֵּן|lehit'aden
עָדִין|adin
לְעַדֵּן|le'aden
עָדִיף|adif
לְהַעֲדִיף|leha'adif
עוֹדֶף|odef
לְהֵיעָדֵר|lehe'ader
לַעֲדוֹר|la'ador
עֲדָשָׁה|adasha
עֲדָשָׁה|adasha
לְהָעִיב|leha'iv
לָעוּג|la'ug
עוּגָה|uga
עוּגִייָּה|ugiya
עֵד|ed
לְהִתְעוֹדֵד|lehit'oded
לְהָעִיד|leha'id
לְעוֹדֵד|le'oded
תְּעוּדָה|te'uda
עוֹד|od
עִידוּד|idud
לְהָעִיז|leha'iz
לָעוּט|la'ut
לְעַוּוֹת|le'avot
עָווֹן|avon
לְהַעֲווֹת|leha'avot
מָעוֹן|ma'on
עוֹנָה|ona
לְהָעִיף|leha'if
לָעוּף|la'uf
לְהִתְעוֹפֵף|lehit'ofef
תְּעוּפָה|te'ufa
לְעוֹפֵף|le'ofef
עוֹף|of
לְהָעִיק|leha'ik
לְהִתְעוֹרֵר|lehit'orer
לְהֵיעוֹר|lehe'or
לְהָעִיר|leha'ir
לְעוֹרֵר|le'orer
לְהִתְעַווֵּר|lehit'aver
לָעוּר|la'ur
עִיווֵּר|iver
הֶעָרָה|he'ara
מְעָרָה|me'ara
עוֹר|or
לְעַווֵּר|le'aver
עִיוּוּת|ivut
לְהִתְעַווֵּת|lehit'avet
לְעַווֵּת|le'avet
לַעֲזוֹב|la'azov
לְהֵיעָזֵב|lehe'azev
עוֹז|oz
לְהָעֵז|leha'ez
מָעוֹז|ma'oz
עַז|az
לְהֵיעָזֵר|lehe'azer
עֶזְרָה|ezra
עֵזֶר|ezer
לַעֲזוֹר|la'azor
עֵט|et
לַעֲטוֹת|la'atot
לְהַעֲטוֹת|leha'atot
עֲטַלֵּף|atalef
לַעֲטוֹף|la'atof
לְהֵיעָטֵף|lehe'atef
לְהִתְעַטֵּף|lehit'atef
מַעֲטָפָה|ma'atafa
עֲטִיפָה|atifa
לְעַטֵּר|le'ater
לְהֵיעָטֵר|lehe'ater
לַעֲטוֹר|la'ator
לְהִתְעַטֵּשׁ|lehit'atesh
עַיִט|ayit
לְעַייֵּן|le'ayen
עִיּוּן|iyun
עַיִן|ayin
לַעֲיוֹן|la'ayon
מַעֲייָן|ma'ayan
עָייֵף|ayef
לְהִתְעַייֵּף|lehit'ayef
לְעַייֵּף|le'ayef
עָייֵף|ayef
עַיִר|ayir
עִיר|ir
עִירִייָּה|iriya
עֵירוֹם|erom
עִירוֹנִי|ironi
לְעַכֵּב|le'akev
לְהִתְעַכֵּב|lehit'akev
עִיכּוּב|ikuv
עֲכָּבִישׁ|akavish
עַכְבָּר|achbar
לְעַכֵּל|le'akel
לְהִתְעַכֵּל|lehit'akel
לְהֵיעָכֵל|lehe'achel
עִיכּוּל|ikul
לְהֵיעָכֵר|lehe'acher
לְהַעֲכִיר|leha'achir
לַעֲכוֹר|la'achor
עַכְשָׁיו|achshav
עַל|al
עַל גַּב|algav
עַל גַּבֵּי|algabei
עַל יַד|alyad
עַל יְדֵי|alyedei
עַל פִּי|alpi
עַל פְּנֵי|alpnei
הַעֲלָאָה|ha'ala'a
עֶלְבּוֹן|elbon
הַעֲלָבָה|ha'alava
לְהֵיעָלֵב|lehe'alev
לְהַעֲלִיב|leha'aliv
לַעֲלוֹב|la'alov
עַלִּיז|aliz
מַעֲלָה|ma'ala
עֶלְיוֹנוּת|elyonut
עֶלְיוֹן|elyon
לְהִתְעַלּוֹת|lehit'alot
מַעְלָה|mala
נַעֲלֶה|na'ale
לְהַעֲלוֹת|leha'alot
מְעוּלֶּה|me'ule
עָלֶה|ale
לְמַעְלָה|lemala
עֲלִיָּה|aliya
עֲלוּת|alut
לַעֲלוֹת|la'alot
עוֹל|ol
לְהִתְעַלֵּל|lehit'alel
לְעוֹלֵל|le'olel
עֲלִילָה|alila
עֲלִילָה|alila
עָלוּל|alul
הִתְעַלְּלוּת|hit'alelut
עַלְמָה|alma
עֶלֶם|elem
לְהֵיעָלֵם|lehe'alem
לְהַעֲלִים|leha'alim
לְהִתְעַלֵּם|lehit'alem
עוֹלָם|olam
הַעֲלָמָה|ha'alama
עוֹלָמִי|olami
הֵיעָלְמוּת|he'almut
עָלוּם|alum
לְהִתְעַלֵּס|lehit'ales
לְעַלְעֵל|le'al'el
לְעַלֵּף|le'alef
לְהִתְעַלֵּף|lehit'alef
עִם|im
לַעֲמוֹד|la'amod
לְהֵיעָמֵד|lehe'amed
לְהַעֲמִיד|leha'amid
מוֹעֳמָד|mo'omad
לְעַמֵּד|le'amed
עִימּוּד|imud
עַמּוּד|amud
מַעֲמָד|ma'amad
עֲמִידָה|amida
עָמִיד|amid
עָמִידוּת|amidut
עֶמְדָּה|emda
מוֹעֳמָדוּת|mo'omadut
לְהִתְעַמֵּל|lehit'amel
הִתְעַמְּלוּת|hit'amlut
לַעֲמוֹל|la'amol
תַּעֲמוּלָה|ta'amula
עַם|am
לְעַמֵּם|le'amem
מוּעָם|mu'am
לַעֲמוֹם|la'amom
עָמוּס|amus
עוֹמֶס|omes
לְהַעֲמִיס|leha'amis
לַעֲמוֹס|la'amos
לְעַמְעֵם|le'am'em
לְהִתְעַמְעֵם|lehit'am'em
לְהַעֲמִיק|leha'amik
לְהִתְעַמֵּק|lehit'amek
עוֹמֶק|omek
עָמוֹק|amok
עֵמֶק|emek
לַעֲמוֹק|la'amok
עוֹמֶר|omer
לְהִתְעַמֵּר|lehit'amer
לְהִתְעַמֵּת|lehit'amet
לְעַמֵּת|le'amet
עִימּוּת|imut
לְעוּמַּת|le'umat
מַעֲמָת|ma'amat
עֲמוּתָּה|amuta
לַעֲנוֹב|la'anov
עֲנִיבָה|aniva
עִנְבָּר|inbar
לְעַנֵּג|le'aneg
לְהִתְעַנֵּג|lehit'aneg
תַּעֲנוּג|ta'anug
לַעֲנוֹד|la'anod
עֵז|ez
לַעֲנוֹת|la'anot
לְעַנּוֹת|le'anot
לְהִתְעַנּוֹת|lehit'anot
לְהֵיעָנוֹת|lehe'anot
עוֹנִי|oni
הֵיעָנוּת|he'anut
תַּעְנִית|ta'anit
מַעֲנֶה|ma'ane
עָנִי|ani
עִנְייָן|inyan
לְעַנְייֵן|le'anyen
לְהִתְעַנְייֵן|lehit'anyen
מְעַנְייֵן|me'anyen
לְהִתְעַנֵּן|lehit'anen
עָנָן|anan
לְהַעֲנִיק|leha'anik
עֲנָק|anak
לְהֵיעָנֵשׁ|lehe'anesh
לְהַעֲנִישׁ|leha'anish
עוֹנֶשׁ|onesh
לַעֲנוֹשׁ|la'anosh
לְעַסּוֹת|le'asot
עִיסּוּי|isuy
עָסִיס|asis
עֲסִיסִי|asisi
לְהִתְעַסֵּק|lehit'asek
לְהַעֲסִיק|leha'asik
עִסְקָה|iska
לַעֲסוֹק|la'asok
עִיסּוּק|isuk
עָסוּק|asuk
עֵסֶק|esek
הַעְפָּלָה|ha'apala
לְהַעְפִּיל|leha'apil
לְעַפְעֵף|le'af'ef
עַפְעַַף|af'af
עָפִיץ|afitz
עֲפִיצוּת|afitzut
עִיפָּרוֹן|iparon
לְהַעֲצִיב|leha'atziv
לְהֵיעָצֵב|lehe'atzev
לְעַצֵּב|le'atzev
עֶצֶב|etzev
עָצָב|atzav
עָצוּב|atzuv
עִיצּוּב|itzuv
לְהִתְעַצֵּב|lehit'atzev
מְעַצֵּב|me'atzev
לְהִתְעַצְבֵּן|lehit'atzben
לְעַצְבֵּן|le'atzben
עֵץ|etz
לְהִתְעַצֵּל|lehit'atzel
עָצֵל|atzel
עַצְלָן|atzlan
עַצְלָן|atzlan
עַצְלוּת|atzlut
מַעֲצָמָה|ma'atzama
לַעֲצוֹם|la'atzom
לְהֵיעָצֵם|lehe'atzem
לְהִתְעַצֵּם|lehit'atzem
עוֹצְמָה|otzma
עֶצֶם|etzem
עֶצֶם|etzem
עֲצוּמָה|atzuma
עַצְמִי|atzmi
עִיצּוּם|itzum
לְהַעֲצִים|leha'atzim
לַעֲצוֹר|la'atzor
לְהֵיעָצֵר|lehe'atzer
עָצִיר|atzir
מַעֲצָר|ma'atzar
עֲצֶרֶת|atzeret
עָצוּר|atzur
עֲצִירוּת|atzirut
עָקוֹב|akov
עָקֵב|akev
עָקֵב|akev
לַעֲקוֹב|la'akov
לַעֲקוֹד|la'akod
לְהִתְעַקֵּל|lehit'akel
לְעַקֵּל|le'akel
עִיקּוּל|ikul
עִיקּוּל|ikul
לְעַקֵּם|le'akem
לְהִתְעַקֵּם|lehit'akem
לְהֵיעָקֵף|lehe'akef
לַעֲקוֹף|la'akof
לַעֲקוֹץ|la'akotz
לְהֵיעָקֵץ|lehe'aketz
לְהֵיעָקֵר|lehe'aker
עִיקָּרוֹן|ikaron
עֶקְרוֹנִי|ekroni
לְעַקֵּר|le'aker
עִיקָר|ikar
לַעֲקוֹר|la'akor
לְהִתְעַקֵּשׁ|lehit'akesh
עִיקֵּשׁ|ikesh
עַקְשָׁן|akshan
הִתְעַקְּשׁוּת|hit'akshut
לַעֲרוֹב|la'arov
לְעָרֵב|le'arev
מַעֲרָב|ma'arav
עַרְבוּת|arvut
עֶרֶב|erev
עָרֵב|arev
עָרֵב|arev
מַעֲרָבָה|ma'arava
מַעֲרָבִי|ma'aravi
עֲרָבָה|arava
לְהִתְעָרֵב|lehit'arev
לְעַרְבֵּב|le'arbev
לְהִתְעַרְבֵּב|lehit'arbev
לְהִתְעַרְבֵּל|lehit'arbel
לְעַרְבֵּל|le'arbel
לְעַרְגֵּל|le'argel
מַעֲרָכוֹן|ma'arachon
לַעֲרוֹךְ|la'aroch
לְהֵיעָרֵךְ|lehe'arech
לְהַעֲרִיךְ|leha'arich
עֵרֶךְ|erech
הַעֲרָכָה|ha'aracha
מַעֲרָךְ|ma'arach
מַעֲרָכָה|ma'aracha
מַעֲרֶכֶת|ma'arechet
עֶרְכָּה|erka
תַּעֲרוּכָה|ta'arucha
עוֹרְלָה|orla
לַעֲרוֹם|la'arom
לְהֵיעָרֵם|lehe'arem
לְהַעֲרִים|leha'arim
עָרוֹם|arom
עָרוּם|arum
עֲרִימָה|arima
עֲרִיסָה|arisa
לְעַרְעֵר|le'ar'er
לְהִתְעַרְעֵר|lehit'ar'er
עִירְעוּר|ir'ur
לַעֲרוֹף|la'arof
עוֹרֶף|oref
לְעַרְפֵּל|le'arpel
עֲרָפֶל|arafel
לְהַעֲרִיץ|leha'aritz
עָרִיץ|aritz
לְהֵיעָרֵץ|lehe'aretz
הַעֲרָצָה|ha'aratza
לַעֲרוֹק|la'arok
לַעֲרוֹר|la'aror
עוֹרְרִין|orerin
לְעַשֵּׂב|le'asev
עֵשֶׂב|esev
לַעֲשׂוֹת|la'asot
תַּעֲשִׂייָּה|ta'asiya
לְהֵיעָשׂוֹת|lehe'asot
עָשׂוּי|asuy
מַעֲשֶׂה|ma'ase
לְעַשּׂוֹת|le'asot
מְעוּשֶּׂה|me'use
תַּעֲשִׂייָּתִי|ta'asiyati
תַּעֲשִׂייָּן|ta'asiyan
לְעַשֵּׁן|le'ashen
עִישּׁוּן|ishun
עָשָׁן|ashan
מְעוּשָּׁן|me'ushan
לַעֲשׁוֹק|la'ashok
לְהַעֲשִׁיר|leha'ashir
לְהִתְעַשֵּׁר|lehit'asher
עֲשִׂירִי|asiri
עָשׂוֹר|asor
לְעַשֵּׂר|le'aser
עָשִׁיר|ashir
עוֹשֶׁר|osher
לְהִתְעַשֵּׁת|lehit'ashet
עָתִיד|atid
עָתִיד|atid
לְהִתְעַתֵּד|lehit'ated
עִיתּוּי|ituy
הֶעְתֵּק|he'etek
לְהַעְתִּיק|leha'atik
עַתִּיק|atik
תַּעְתִּיק|ta'atik
לְהֵיעָתֵק|lehe'atek
עוֹתֵר|oter
לַעֲתוֹר|la'ator
לְהֵיעָתֵר|lehe'ater
לְהַעֲתִיר|leha'atir
לְהַעֲתִיר|leha'atir
עֲתִירָה|atira
עֵת|et
עִיתּוֹן|iton
עִיתּוֹנַאי|itonay
עִיתּוֹנוּת|itonut
עִיתּוֹנָאוּת|itona'ut
עַתָּה|ata
לְפָאֵר|lefa'er
לְהִתְפָּאֵר|lehitpa'er
תִּפְאֶרֶת|tif'eret
פְּאֵר|pe'er
לְהַפְגִּיז|lehafgiz
פָּגָז|pagaz
פְּגִימָה|pgima
פָּגוּם|pagum
לְהִיפָּגֵם|lehipagem
פִּיגּוּם|pigum
פְּגָם|pgam
לִפְגּוֹם|lifgom
לְהַפְגִּין|lehafgin
הַפְגָּנָה|hafgana
לְהִיפָּגֵעַ|lehipagea
פְּגִיעָה|pgi'a
פִּיגּוּעַ|pigua
לִפְגּוֹעַ|lifgoa
לְהַפְגִּיעַ|lehafgia
לִפְגּוֹר|lifgor
לְפַגֵּר|lefager
פִּיגּוּר|pigur
מְפַגֵּר|mefager
לְהִתְפַּגֵּר|lehitpager
לִפְגּוֹשׁ|lifgosh
לְהִיפָּגֵשׁ|lehipagesh
לְהַפְגִּישׁ|lehafgish
פְּגִישָׁה|pgisha
פָּגוֹשׁ|pagosh
לְהִתְפַדֵּחַ|lehitfadeach
לְהִיפָּדוֹת|lehipadot
לִפְדּוֹת|lifdot
פְּדוּת|pdut
לְפַדֵּר|lefader
לְהִתְפַּדֵּר|lehitpader
פֶּה|pe
פֹּה|po
לְפַהֵק|lefahek
לָפוּג|lafug
לְהָפִיג|lehafig
לְהִתְפּוֹגֵג|lehitpogeg
לְהָפִיחַ|lehafiach
פּוֹל|pol
פּוֹלִיטִיקָה|politika
פּוּנְדָּק|pundak
פּוּנְדְּקָאוּת|pundeka'ut
פּוּנְדְּקַאי|pundekay
פּוּנְדְּקָאִית|pundeka'it
לְהָפִיץ|lehafitz
נָפוֹץ|nafotz
הֲפָצָה|hafatza
לְהִיפֵּץ|lehipetz
לְהִיפּוֹץ|lehipotz
לָפוּץ|lafutz
לְהָפִיק|lehafik
תְּפוּקָה|tfuka
לְפוֹרֵר|leforer
לְהִתְפּוֹרֵר|lehitporer
לִפְזוֹל|lifzol
לְפַזֵּם|lefazem
פִּזְמוֹן|pizmon
לְהִתְפַּזֵּר|lehitpazer
לְפַזֵּר|lefazer
לִפְחוֹד|lifchod
לְהַפְחִיד|lehafchid
לְפַחֵד|lefached
פַּחַד|pachad
פַּחְדָן|pachdan
לִפְחוֹז|lifchoz
לְפַחֵם|lefachem
לְהִתְפַּחֵם|lehitpachem
לִפְחוֹס|lifchos
לִפְחוֹת|lifchot
לְהַפְחִית|lehafchit
פָּחוֹת|pachot
פִּיחוּת|pichut
פְּחִיתוּת|pchitut
לְפַטֵּם|lefatem
לְהִתְפַּטֵּם|lehitpatem
לְפַטְפֵּט|lefatpet
לְהִיפָּטֵר|lehipater
לְפַטֵּר|lefater
פָּטוּר|patur
פְּטוֹר|ptor
לְהִתְפַּטֵּר|lehitpater
לִפְטוֹר|liftor
לְהַפְטִיר|lehaftir
פְּטִירָה|ptira
פַּטִּישׁ|patish
לְפַייֵּחַ|lefayeach
פִּיל|pil
פִילוֹסוֹפְיָה|filosofya
לְהִתְפַּייֵּס|lehitpayes
לְפַייֵּס|lefayes
הִתְפַּייְּסוּת|hitpaysut
פִּיּוּס|piyus
מֵפִיק|mefik
לְהִתְפַּכֵּחַ|lehitpakeach
פִּיכֵּחַ|pikeach
לְפַכּוֹת|lefakot
לְהִתְפַּלֵּא|lehitpale
לְהַפְלִיא|lehafli
פֶּלֶא|pele
לְהִיפָּלֵא|lehipale
נִפְלָא|nifla
פָלָאפֶל|falafel
לְפַלֵּג|lefaleg
לְהִתְפַּלֵּג|lehitpaleg
לְהַפְלִיג|lehaflig
פְּלוּגָּה|pluga
מִפְלָגָה|miflaga
הִתְפַּלְּגוּת|hitpalgut
פִּילּוּג|pilug
פְּלָדָה|plada
לְפַלֵּחַ|lefaleach
פֶּלַח|pelach
לִפְלוֹחַ|lifloach
פָּלִיט|palit
לְהִיפָּלֵט|lehipalet
לִפְלוֹט|liflot
לְהַפְלִיט|lehaflit
פֶּלֶט|pelet
לְהַפְלוֹת|lehaflot
הַפְלָיָה|haflaya
אַפְלָיָה|aflaya
פֶּלֶךְ|pelech
לְהַפְלִיל|lehaflil
לְפַלֵּל|lefalel
לְהִתְפַּלֵּל|lehitpalel
פְּלִילִי|plili
תְּפִילָּה|tfila
מִפְלָס|miflas
לְפַלֵּס|lefales
לְהִתְפַּלְסֵף|lehitpalsef
לְפַלְפֵּל|lefalpel
לְהִתְפַּלְפֵּל|lehitpalpel
לְהַפְלִיץ|lehaflitz
מִפְלֶצֶת|mifletzet
לִפְלַרְטֵט|liflartet
לִפְלוֹשׁ|liflosh
לְהִתְפַּלֵּשׁ|lehitpalesh
פָּמוֹט|pamot
לְפַמְפֵּם|lefampem
פֶּן|pen
פָּן|pan
פְּנַאי|pnay
פֶּנְדֶּל|pendel
מְפוּנְטָז|mefuntaz
לְפַנְטֵז|lefantez
לִפְנוֹת|lifnot
לְהִיפָּנוֹת|lehipanot
לְפַנּוֹת|lefanot
לְהַפְנוֹת|lehafnot
פָּנוּי|panuy
פִּינּוּי|pinuy
פְּנִיָּה|pniya
לְהִתְפַּנּוֹת|lehitpanot
פְּנִייָּה|pniya
פָּנִים|panim
פְּנִים|pnim
לְהַפְנִים|lehafnim
פְּנִימִי|pnimi
פְּנִים|pnim
פְּנִימָה|pnima
פְּנִינָה|pnina
פָּנָס|panas
לְפַנֵּק|lefanek
לְהִתְפַּנֵּק|lehitpanek
פִּינּוּק|pinuk
פִּנְקָס|pinkas
פִּסְגָּה|pisga
לְהַפְסִיד|lehafsid
הֶפְסֵד|hefsed
נִפְסָד|nifsad
לִפְסוֹחַ|lifsoach
לְהִיפָּסֵחַ|lehipaseach
פְּסִיכוֹלוֹגְיָה|psichologya
לְפַסֵּל|lefasel
לְהִיפָּסֵל|lehipasel
פֶּסֶל|pesel
פְּסוֹלֶת|psolet
מַפְסֶלֶת|mafselet
פַּסָּל|pasal
פָּסוּל|pasul
לִפְסוֹל|lifsol
פִּיסּוּל|pisul
פְּסַנְתֵּר|psanter
פַּס|pas
לִפְסוֹעַ|lifsoa
פְּסִיעָה|psi'a
לְפַסְפֵס|lefasfes
לְהִתְפַסְפֵס|lehitfasfes
לְהִיפָּסֵק|lehipasek
לְהַפְסִיק|lehafsik
הַפְסָקָה|hafsaka
הֶפְסֵק|hefsek
פְּסִיק|psik
פְּסָק|psak
פֶּסֶק|pesek
מַפְסֵק|mafsek
מַפְסִיק|mafsik
לִפְסוֹק|lifsok
פִּסְקָה|piska
פָּעוֹט|pa'ot
לִפְעוֹת|lif'ot
פְּעִילוּת|pe'ilut
לִפְעוֹל|lif'ol
לְהַפְעִיל|lehaf'il
פְּעוּלָּה|pe'ula
פָּעִיל|pa'il
פּוֹעַל|po'al
מִפְעָל|mif'al
פְּעַלְתָּן|pe'altan
פּוֹעֵל|po'el
פָּעִיל|pa'il
לְהִתְפַּעֵל|lehitpa'el
לְהִתְפַּעֵם|lehitpa'em
פַּעֲמוֹן|pa'amon
לִפְעוֹם|lif'om
לְהִיפָּעֵם|lehipa'em
לְהַפְעִים|lehaf'im
פַּעַם|pa'am
לְפַעֵם|lefa'em
לְפַעְנֵחַ|lefa'aneach
לְפַעְפֵּעַ|lefa'apea
פַּעַר|pa'ar
לִפְעוֹר|lif'or
לְהִיפָּעֵר|lehipa'er
לְפַצֵּחַ|lefatzeach
לִפְצוֹת|liftzot
לְפַצּוֹת|lefatzot
פִּיצּוּי|pitzuy
לְפַצֵּל|lefatzel
לְהִתְפַּצֵּל|lehitpatzel
לְהִיפָּצֵעַ|lehipatzea
לִפְצוֹעַ|liftzoa
פָּצוּעַ|patzua
לְהַפְצִיעַ|lehaftzia
פְּצִיעָה|ptzi'a
לְפַצְפֵּץ|lefatzpetz
לְהִתְפַּצְפֵּץ|lehitpatzpetz
לְפוֹצֵץ|lefotzetz
פְּצָצָה|ptzatza
לְהַפְצִיץ|lehaftzitz
לְהִתְפּוֹצֵץ|lehitpotzetz
לְהַפְצִיר|lehaftzir
לְהִיפָּקֵד|lehipaked
לְפַקֵּד|lefaked
לְהַפְקִיד|lehafkid
לִפְקוֹד|lifkod
פְּקוּדָּה|pkuda
תַּפְקִיד|tafkid
לְהִתְפַּקֵּד|lehitpaked
פָּקִיד|pakid
מִפְקָד|mifkad
פָקוּלְטָה|fakulta
לִפְקוֹחַ|lifkoach
לְהִיפָּקֵחַ|lehipakeach
לְפַקֵּחַ|lefakeach
לְהִתְפַּקֵּחַ|lehitpakeach
פָּקוּחַ|pakuach
פִּיקּוּחַ|pikuach
פִּיקֵּחַ|pikeach
לְפַקְסֵס|lefakses
לְהַפְקִיעַ|lehafkia
לְהִתְפַּקֵּעַ|lehitpakea
לִפְקוֹעַ|lifkoa
לְפַקְפֵּק|lefakpek
פִּיקְפּוּק|pikpuk
פִּיקָּה|pika
פַּקֶּקֶת|pakeket
פְּקָק|pkak
לְהַפְקִיר|lehafkir
לְהִתְפַקְשֵׁשׁ|lehitfakshesh
פַּר|par
פֶּרְגּוֹלָה|pergola
לְפַרְגֵּן|lefargen
פָּרוּד|parud
לְהַפְרִיד|lehafrid
לְהִיפָּרֵד|lehipared
פְּרֵידָה|preda
הַפְרָדָה|hafrada
נִפְרָד|nifrad
פֶּרֶד|pered
פָּרָה|para
פַּרְווָר|parvar
פֵּרוּק|peruk
לְפָרֵז|lefarez
לְהַפְרִיז|lehafriz
פִּירְזוּל|pirzul
לִפְרוֹחַ|lifroach
לְהַפְרִיחַ|lehafriach
פֶּרַח|perach
פְּרִיחָה|pricha
אֶפְרוֹחַ|efroach
תַּפְרִיט|tafrit
פְּרִיט|prit
פְּרָטִי|prati
לְהִיפָּרֵט|lehiparet
לְפָרֵט|lefaret
פְּרָט|prat
לְהַפְרִיט|lehafrit
הַפְרָטָה|hafrata
לִפְרוֹט|lifrot
לִפְרוֹת|lifrot
לְהַפְרוֹת|lehafrot
הַפְרָיָה|hafraya
פִּרְיוֹן|piryon
פְּרִי|pri
לְהַפְרִיךְ|lehafrich
לְפָרֵךְ|lefarech
פֶּרֶךְ|perech
לְפַרְכֵּס|lefarkes
לְהִתְפַּרְכֵּס|lehitparkes
לְהִיפָּרֵם|lehiparem
פֶּרֶם|perem
לִפְרוֹם|lifrom
פַּרְנָסָה|parnasa
פַּרְנָס|parnas
לְהִתְפַּרְנֵס|lehitparnes
לְפַרְנֵס|lefarnes
לִפְרוֹס|lifros
לְהִיפָּרֵס|lehipares
לְהִתְפָּרֵס|lehitpares
פְּרָס|pras
פְּרִיסָה|prisa
לְהִתְפַּרְסֵם|lehitparsem
לְפַרְסֵם|lefarsem
פִּירְסוּם|pirsum
פִּירְסוֹמֶת|pirsomet
פִּירְסוֹמֶת|pirsomet
מְפוּרְסָם|mefursam
לְהִתְפָּרֵעַ|lehitparea
לְהַפְרִיעַ|lehafria
לִפְרוֹעַ|lifroa
לְהִיפָּרֵעַ|lehiparea
לִפְרוֹף|lifrof
לְהִתְפַּרְפֵּר|lehitparper
לְפַרְפֵּר|lefarper
פַּרְפָּר|parpar
לִפְרוֹץ|lifrotz
לְהִיפָּרֵץ|lehiparetz
מִפְרָץ|mifratz
פְּרִיצָה|pritza
פֶּרֶץ|peretz
לְהִתְפָּרֵץ|lehitparetz
פָּרוּץ|parutz
פַּרְצוּף|partzuf
לְפָרֵק|lefarek
לְהִתְפָּרֵק|lehitparek
פֶּרֶק|perek
מִפְרָק|mifrak
לִפְרוֹק|lifrok
לְהִיפָּרֵק|lehiparek
פָּרִיק|parik
פֵּירוּק|peruk
לְפַרְקֵד|lefarked
פְּרַקְלִיט|praklit
לְהִתְפּוֹרֵר|lehitporer
לְפוֹרֵר|leforer
הֲפָרָה|hafara
לְהָפֵר|lehafer
לְפוֹרֵר|leforer
פֵּירוּשׁ|perush
לְהַפְרִישׁ|lehafrish
לְפָרֵשׁ|lefaresh
לְהִיפָּרֵשׂ|lehipares
פָּרָשׁ|parash
הֶפְרֵשׁ|hefresh
מִפְרָשׂ|mifras
לְהִתְפָּרֵשׁ|lehitparesh
לִפְרוֹשׁ|lifrosh
לִפְרוֹשׂ|lifros
פַּרְשָׁן|parshan
פַּרְשָׁנוּת|parshanut
לְפַרְשֵׁן|lefarshen
לְפַשֵּׁט|lefashet
פָּשׁוּט|pashut
הַפְשָׁטָה|hafshata
לְהַפְשִׁיט|lehafshit
לִפְשׁוֹט|lifshot
לְהִיפָּשֵׁט|lehipashet
לְהִתְפַּשֵּׁט|lehitpashet
לִפְשׂוֹת|lifsot
לְהִתְפַשֵּׁל|lehitfashel
לְהַפְשִׁיל|lehafshil
לְפַשֵּׁל|lefashel
לִפְשׁוֹעַ|lifshoa
לְפַשְׁפֵּשׁ|lefashpesh
פִּישְׁפֵּשׁ|pishpesh
לִפְשׁוֹק|lifshok
לִפְשׂוֹק|lifsok
לְפַשֵּׂק|lefasek
לְפַשֵּׁר|lefasher
לְהִתְפַּשֵּׁר|lehitpasher
לְהַפְשִׁיר|lehafshir
פְּשָׁרָה|pshara
פּוֹשֵׁר|posher
פִּתְאוֹמ|pit'om
פִּתְאוֹמִי|pit'omi
הִתְפַּתְּחוּת|hitpatchut
פִּיתּוּחַ|pituach
לְהִיפָּתֵחַ|lehipateach
לְפַתֵּחַ|lefateach
לְהִתְפַּתֵּחַ|lehitpateach
פֶּתַח|petach
פְּתִיחָה|pticha
מַפְתֵּחַ|mafteach
פָּתוּחַ|patuach
לִפְתּוֹחַ|liftoach
לְפַתּוֹת|lefatot
פִּיתּוּי|pituy
לְהִתְפַּתּוֹת|lehitpatot
פִּיתָּיוֹן|pitayon
לְפַתֵּל|lefatel
לְהִתְפַּתֵּל|lehitpatel
פִּיתּוּל|pitul
פְּתִיל|ptil
לְהַפְתִּיעַ|lehaftia
הַפְתָּעָה|hafta'a
פֶּתַע|peta
פֶּתֶק|petek
לִפְתּוֹר|liftor
לְהִיפָּתֵר|lehipater
פִּתְרוֹן|pitron
פִּיתָּה|pita
פַּת|pat
צֹאן|tzon
צֶאֱצָא|tze'etza
לְהַצְבִּיא|lehatzbi
צָבָא|tzava
צַב|tzav
לִצְבּוֹט|litzbot
לְהִיצָּבֵט|lehitzavet
צִבְעוֹנִי|tziv'oni
צֶבַע|tzeva
לִצְבּוֹעַ|litzboa
לְהִיצָּבֵעַ|lehitzavea
לְהַצְבִּיעַ|lehatzbia
צַבָּע|tzaba
אֶצְבַּע|etzba
לִצְבּוֹר|litzbor
לְהִיצָּבֵר|lehitzaver
לְהִצְטַבֵּר|lehitztaber
מַצְבֵּר|matzber
צִיבּוּר|tzibur
צִיבּוּרִי|tziburi
צְבָת|tzvat
צַד|tzad
לְצַדֵּד|letzaded
לְהַצְדִּיעַ|lehatzdia
הַצְדָּעָה|hatzda'a
לְהִצְטַדֵּק|lehitztadek
לִצְדּוֹק|litzdok
לְהַצְדִּיק|lehatzdik
צְדָקָה|tzdaka
הַצְדָּקָה|hatzdaka
צֶדֶק|tzedek
צַדִּיק|tzadik
צַדִּיק|tzadik
מוּצְדָּק|mutzdak
צְהַבְהַב|tzehavhav
לְהַצְהִיב|lehatzhiv
צָהוֹב|tzahov
לִצְהוֹל|litzhol
צוֹהֳרַייִם|tzohorayim
לְהַצְהִיר|lehatzhir
הַצְהָרָה|hatzhara
צוֹהֳרַייִם|tzohorayim
צוֹהַר|tzohar
לָצוּד|latzud
לְהִיצּוֹד|lehitzod
צָווָאר|tzavar
לִצְווֹחַ|litzvoach
לְצַווֵּחַ|letzaveach
לְהִצְטַוּוֹת|lehitztavot
מִצְווָה|mitzva
צַו|tzav
לְצַוּוֹת|letzavot
צִיוּוּי|tzivuy
צוֹל|tzol
מְצוּלָה|metzula
לָצוּם|latzum
צוֹם|tzom
לָצוּף|latzuf
לְהָצִיף|lehatzif
הֲצָפָה|hatzafa
לְהָצִיץ|lehatzitz
הֲצָצָה|hatzatza
לָצוּץ|latzutz
לְהָצִיק|lehatzik
מְצוּקָה|metzuka
הֲצָקָה|hatzaka
מָצוֹר|matzor
צוּרָה|tzura
לָצוּר|latzur
צֶווֶת|tzevet
צַח|tzach
לְצַחְצֵחַ|letzachtzeach
לִצְחוֹק|litzchok
לְהַצְחִיק|lehatzchik
צְחוֹק|tzchok
לְצַחֵק|letzachek
לְצַחְקֵק|letzachkek
לְצַטֵּט|letzatet
צִי|tzi
לְצַייֵּד|letzayed
לְהִצְטַייֵּד|lehitztayed
צִיּוּד|tziyud
לְצַייֵּן|letzayen
לְהִצְטַייֵּן|lehitztayen
מְצוּיָּן|metzuyan
צִינּוֹר|tzinor
צִינִי|tzini
צִינִיּוּת|tziniyut
צִיפּוֹרֶן|tziporen
צִיפּוֹרֶן|tziporen
צִיפּוֹרֶן|tziporen
לְצַייֵּץ|letzayetz
צִיּוּץ|tziyutz
לְהִצְטַייֵּר|lehitztayer
צַייָּר|tzayar
לְצַייֵּר|letzayer
צִיּוּר|tziyur
צַייְתָן|tzaytan
לְצַייֵּת|letzayet
צַלְבָן|tzalvan
צְלָב|tzlav
לְהִצְטַלֵּב|lehitztalev
לְהַצְלִיב|lehatzliv
הִצְטַלְּבוּת|hitztalvut
הַצְלָחָה|hatzlacha
מוּצְלָח|mutzlach
לִצְלוֹחַ|litzloach
לְהַצְלִיחַ|lehatzliach
צַלַּחַת|tzalachat
לְהִיצָּלוֹת|lehitzalot
לִצְלוֹת|litzlot
לִצְלוֹל|litzlol
צְלִיל|tzlil
צֵל|tzel
לְהָצֵל|lehatzel
לְהִצְטַלֵּל|lehitztalel
הֲצַלָּה|hatzala
הֲצַלָּה|hatzala
לְצַלֵּם|letzalem
לְהִצְטַלֵּם|lehitztalem
צֶלֶם|tzelem
צַלָּם|tzalam
צִילּוּם|tzilum
מַצְלֵמָה|matzlema
תַּצְלוּם|tatzlum
לִצְלוֹעַ|litzloa
צֶלַע|tzela
מְצוּלָּע|metzula
מְצוּלָּע|metzula
לְהַצְלִיף|lehatzlif
צַלָּף|tzalaf
לִצְלוֹף|litzlof
לְצַלְצֵל|letzaltzel
צִילְצוּל|tziltzul
צַלֶּקֶת|tzaleket
צָמֵא|tzame
לִצְמוֹא|litzmo
צִימָּאוֹן|tzima'on
צָמִיג|tzamig
צְמִיגוּת|tzmigut
צְמִיג|tzmig
לְהַצְמִיד|lehatzmid
לְהִיצָּמֵד|lehitzamed
צָמִיד|tzamid
צֶמֶד|tzemed
צָמוּד|tzamud
לִצְמוֹחַ|litzmoach
לְהַצְמִיחַ|lehatzmiach
צִמְחוֹנִי|tzimchoni
צִמְחוֹנוּת|tzimchonut
צֶמַח|tzemach
לְהִצְטַמְצֵם|lehitztamtzem
צַמְצָם|tzamtzam
לְצַמְצֵם|letzamtzem
לְהִצְטַמֵּק|lehitztamek
צֶמֶר|tzemer
צַמְרִי|tzamri
צַמֶּרֶת|tzameret
לְהִצְטַמְרֵר|lehitztamrer
צוֹמֶת|tzomet
לִצְמוֹת|litzmot
לִצְנוֹחַ|litznoach
לְהַצְנִיחַ|lehatzniach
צַנְחָן|tzanchan
מִצְנָח|mitznach
מַצְנֵחַ|matzneach
מְצוּנָּן|metzunan
לְצַנֵּן|letzanen
לְהִצְטַנֵּן|lehitztanen
לְהָצֵן|lehatzen
הִצְטַנְּנוּת|hitztanenut
לְהִצְטַנֵּעַ|lehitztanea
לְהַצְנִיעַ|lehatznia
צָנוּעַ|tzanua
צֶנַע|tzena
מוּצְנָע|mutzna
לְהַצְנִיף|lehatznif
מִצְנֶפֶת|mitznefet
צָנִיף|tzanif
לְהִצְטַנֵּף|lehitztanef
לִצְנוֹף|litznof
לְצַנְרֵר|letzanrer
צִינְרוּר|tzinrur
צַנְתָּר|tzantar
לְצַנְתֵּר|letzanter
צִינְתּוּר|tzintur
לִצְעוֹד|litz'od
לְהַצְעִיד|lehatz'id
מִצְעָד|mitz'ad
צַעַד|tza'ad
צְעִידָה|tze'ida
צַעֲדָה|tza'ada
לִצְעוֹת|litz'ot
צָעִיף|tza'if
צַעֲצוּעַ|tza'atzua
לִצְעוֹק|litz'ok
צְעָקָה|tze'aka
לְהִצְטַעֵק|lehitzta'ek
לְצַעֵר|letza'er
לְהִצְטַעֵר|lehitzta'er
צָעִיר|tza'ir
צַעַר|tza'ar
מִצְפֶּה|mitzpe
צָפוּי|tzafuy
צֶפִי|tzefi
לְהִיצָּפוֹת|lehitzafot
לְצַפּוֹת|letzapot
לִצְפּוֹת|litzpot
צִיפִּיָּה|tzipiya
מַצְפֵּן|matzpen
לִצְפּוֹן|litzpon
לְהִיצָּפֵן|lehitzafen
צָפוֹן|tzafon
צוֹפֶן|tzofen
צָפוֹנָה|tzafona
צְפוֹנִי|tzfoni
מַצְפּוּן|matzpun
לְהַצְפִּין|lehatzpin
צָפוּף|tzafuf
לְצוֹפֵף|letzofef
לְהִצְטוֹפֵף|lehitztofef
צְפִיפוּת|tzfifut
לְצַפְצֵף|letzaftzef
לִצְפּוֹר|litzpor
צַפָּר|tzapar
צִיפּוֹר|tzipor
צְפַרְדֵּעַ|tzfardea
לִצְרוֹב|litzrov
צָרוּב|tzaruv
צָרֶבֶת|tzarevet
לְהִצְטָרֵד|lehitztared
לִצְרוֹחַ|litzroach
צַרְחָן|tzarchan
צְרִיחַ|tzriach
לְהִצְטָרֵךְ|lehitztarech
לִצְרוֹךְ|litzroch
לְהַצְרִיךְ|lehatzrich
צָרִיךְ|tzarich
צוֹרֶךְ|tzorech
צַרְכָן|tzarchan
מִצְרָךְ|mitzrach
לְהִיצָּרֵךְ|lehitzarech
צַרְכָנוּת|tzarchanut
לִצְרוֹם|litzrom
לְהִצְטָרֵף|lehitztaref
לְצָרֵף|letzaref
צְרִיף|tzrif
לִצְרוֹף|litzrof
לְצַרְצֵר|letzartzer
צִירְצוּר|tzirtzur
לִצְרוֹר|litzror
צַר|tzar
לְהָצֵר|lehatzer
צָרָה|tzara
לְצוֹתֵת|letzotet
לִקְבּוֹל|likbol
לְקַבֵּל|lekabel
לְהִתְקַבֵּל|lehitkabel
לְהַקְבִּיל|lehakbil
קַבָּלָה|kabala
קִיבּוֹלֶת|kibolet
קַבָּל|kabal
קִיבּוּל|kibul
לְהִיקָּבֵעַ|lehikavea
קָבוּעַ|kavua
לְהִתְקַבֵּעַ|lehitkabea
לִקְבּוֹעַ|likboa
קְבִיעוּת|kvi'ut
קְבוּצָה|kvutza
לְהִיקָּבֵץ|lehikavetz
לְקַבֵּץ|lekabetz
קוֹבֶץ|kovetz
קַבְּצָן|kabtzan
לְהִתְקַבֵּץ|lehitkabetz
קִיבּוּץ|kibutz
לִקְבּוֹר|likbor
לְהִיקָּבֵר|lehikaver
קָבוּר|kavur
קְבוּרָה|kvura
קֵבֶר|kever
קַבַּרְנִיט|kabarnit
לָקוֹד|lakod
לְקַדֵּד|lekaded
קַדַּחַת|kadachat
לְהַקְדִּיחַ|lehakdiach
לִקְדּוֹחַ|likdoach
לְהִיקָּדֵחַ|lehikadeach
מַקְדֵּחָה|makdecha
אֶקְדָּח|ekdach
מוּקְדָּם|mukdam
לְקַדֵּם|lekadem
לְהַקְדִּים|lehakdim
לְהִתְקַדֵּם|lehitkadem
הִתְקַדְּמוּת|hitkadmut
קִדְמָה|kidma
קִידּוֹמֶת|kidomet
קָדִימָה|kadima
הַקְדָּמָה|hakdama
תַּקְדִּים|takdim
לִקְדּוֹם|likdom
לְהִתְקַדֵּר|lehitkader
לִקְדּוֹר|likdor
קַדָּר|kadar
קַדָּרוּת|kadarut
קָדוֹשׁ|kadosh
לְקַדֵּשׁ|lekadesh
לְהִתְקַדֵּשׁ|lehitkadesh
לְהַקְדִּישׁ|lehakdish
מִקְדָּשׁ|mikdash
קוֹדֶשׁ|kodesh
לְהִתְקַהוֹת|lehitkahot
לְהַקְהוֹת|lehakhot
קְהִילָּה|kehila
לְהִתְקַהֵל|lehitkahel
מַקְהֵלָה|makhela
לְהִיקָּהֵל|lehikahel
קָהָל|kahal
קְהִלָּתִי|kehilati
קַו|kav
לְקַוּוֹת|lekavot
לְהִיקָּווֹת|lehikavot
תִּקְווָה|tikva
קוֹל|kol
קוֹלְנוֹעַ|kolnoa
לָקוּם|lakum
לְהָקִים|lehakim
לְקוֹמֵם|lekomem
לְהִתְקוֹמֵם|lehitkomem
מָקוֹם|makom
תְּקוּמָה|tkuma
יְקוּם|yekum
מְקוֹמִי|mekomi
הֲקָמָה|hakama
מֵקִים|mekim
קוֹמָה|koma
קוֹמוּנִיסְט|komunist
קוּמְקוּם|kumkum
קִינָה|kina
מְקוּוָּן|mekuvan
לְקוֹנֵן|lekonen
תְּקוּפָה|tkufa
קוֹף|kof
קוּפַּאי|kupay
קוּפָּה|kupa
קוּפְסָה|kufsa
לָקוּץ|lakutz
מָקוֹר|makor
לְקַזֵּז|lekazez
לְהִתְקַזֵּז|lehitkazez
לְקַטֵּב|lekatev
לְהִתְקוֹטֵט|lehitkotet
לִקְטוֹל|liktol
לְהִיקָּטֵל|lehikatel
לְקַטֵּל|lekatel
לְהִתְקַטֵּל|lehitkatel
לִקְטוֹן|likton
לְהַקְטִין|lehaktin
קָטָן|katan
לִקְטוֹעַ|liktoa
לְהִיקָּטֵעַ|lehikatea
קֶטַע|keta
לִקְטוֹף|liktof
לְהִיקָּטֵף|lehikatef
קְטִיפָה|ktifa
לְקַטֵּר|lekater
קַטָּר|katar
קִיטוֹר|kitor
לְהַקְטִיר|lehaktir
קוֹטֶר|koter
לְהָקִיא|lehaki
קֵיבָה|keiva
לְקַייֵּם|lekayem
לְהִתְקַייֵּם|lehitkayem
קִיּוּם|kiyum
קַייָּם|kayam
קִינָמוֹן|kinamon
לְהָקִיץ|lehakitz
קַיִץ|kayitz
קִיר|kir
לְהַקְלִיד|lehaklid
הַקְלָדָה|haklada
מִקְלֶדֶת|mikledet
לְהִתְקַלֵּחַ|lehitkaleach
לִקְלוֹחַ|likloach
מִקְלַחַת|miklachat
לְקַלֵּחַ|lekaleach
לְהַקְלִיט|lehaklit
לְהִיקָּלֵט|lehikalet
מִקְלָט|miklat
הַקְלָטָה|haklata
הִיקָּלְטוּת|hikaltut
קַלֶּטֶת|kaletet
מַקְלֵט|maklet
תַּקְלִיט|taklit
לִקְלוֹט|liklot
קְלִיטָה|klita
קֶלֶט|kelet
לִקְלוֹת|liklot
לְהִיקָּלוֹת|lehikalot
קָלוֹן|kalon
קַלּוּת|kalut
לְקַלֵּל|lekalel
לְהָקֵל|lehakel
קְלָלָה|klala
קַל|kal
לְהִיקָּלֵעַ|lehikalea
קֶלַע|kela
קָלָע|kala
מַקְלֵעַ|maklea
קָלִיעַ|kalia
לִקְלוֹעַ|likloa
לְקַלֵּף|lekalef
לִקְלוֹף|liklof
לְהִתְקַלֵּף|lehitkalef
קְלָף|klaf
קְלִפָּה|klipa
לְהַקְלִיק|lehaklik
לְקַלְקֵל|lekalkel
לְהִתְקַלְקֵל|lehitkalkel
קִלְשׁוֹן|kilshon
קֶמַח|kemach
לְקַמֵּט|lekamet
לְהִתְקַמֵּט|lehitkamet
לְהִיקָּמֵל|lehikamel
לְקַמֵּץ|lekametz
קַמְצָן|kamtzan
קוֹמֶץ|kometz
לִקְמוֹץ|likmotz
לְהִתְקַמֵּץ|lehitkametz
לְהִתְקַמְצֵן|lehitkamtzen
קְמִירָה|kmira
קָמוּר|kamur
לְקַמֵּר|lekamer
קֶמֶר|kemer
קִמְרוֹן|kimron
קִנְאָה|kin'a
קַנָּא|kana
קַנַּאי|kanay
קַנָּאוּת|kana'ut
לְקַנֵּא|lekane
לְהִתְקַנֵּא|lehitkane
לְקַנֵּחַ|lekaneach
לְהַקְנִיט|lehaknit
הַקְנָטָה|haknata
לְקַנְטֵר|lekanter
לִקְנוֹת|liknot
לְהִיקָּנוֹת|lehikanot
לְהַקְנוֹת|lehaknot
קְנִיָּה|kniya
קָנוּי|kanuy
קַנְיוֹן|kanyon
קַנְיוֹן|kanyon
קְנִייָּה|kniya
לְקַנֵּן|lekanen
קְנָס|knas
לִקְנוֹס|liknos
לְהִיקָּנֵס|lehikanes
קַסְדָּה|kasda
לִקְסוֹם|liksom
לְהַקְסִים|lehaksim
קֶסֶם|kesem
לְקַעְקֵעַ|leka'akea
קָעוּר|ka'ur
קְעִירָה|ke'ira
קְעָרָה|ke'ara
לְהִיקָּפֵא|lehikafe
לְהַקְפִּיא|lehakpi
הַקְפָּאָה|hakpa'a
קִיפָּאוֹן|kipa'on
לִקְפּוֹא|likpo
לְקַפֵּד|lekaped
לְהַקְפִּיד|lehakpid
קָפֶה|kafe
מְקוּפָּח|mekupach
לְקַפֵּחַ|lekapeach
לִקְפּוֹחַ|likpoach
לְקַפּוֹת|lekapot
לְקַפֵּל|lekapel
לְהִתְקַפֵּל|lehitkapel
קִיפּוּל|kipul
לְהַקְפִּיץ|lehakpitz
קְפִיץ|kfitz
לִקְפּוֹץ|likpotz
לְקַפֵּץ|lekapetz
מוּקְפָּץ|mukpatz
לְהַקְצִיב|lehaktziv
קֶצֶב|ketzev
קַצָּב|katzav
קִצְבָּה|kitzba
תַּקְצִיב|taktziv
קָצוּב|katzuv
קְצוּבָּה|ktzuba
לִקְצוֹב|liktzov
קִצְבָּה|kitzba
לְהַקְצוֹת|lehaktzot
לְהַקְצִין|lehaktzin
קָצִין|katzin
מִקְצוֹעִי|miktzo'i
לְהַקְצִיעַ|lehaktzia
מִקְצוֹעַ|miktzoa
קַצֶּפֶת|katzefet
קֶצֶף|ketzef
לִקְצוֹף|liktzof
קֶצֶף|ketzef
לְהַקְצִיף|lehaktzif
לְקַצֵּץ|lekatzetz
לִקְצוֹץ|liktzotz
קָצִיר|katzir
לִקְצוֹר|liktzor
לְהִיקָּצֵר|lehikatzer
לְקַצֵּר|lekatzer
לְהִתְקַצֵּר|lehitkatzer
קָצָר|katzar
קֶצֶר|ketzer
קַצֶּרֶת|katzeret
קִיצּוּר|kitzur
תַּקְצִיר|taktzir
קְצָת|ktzat
לִקְרוֹא|likro
לְהִיקָּרֵא|lehikare
לְהַקְרִיא|lehakri
קְרִיאָה|kri'a
לִקְרוֹב|likrov
לְקָרֵב|lekarev
לְהִתְקָרֵב|lehitkarev
לְהַקְרִיב|lehakriv
הַקְרָבָה|hakrava
קִרְבָה|kirva
קָרוֹב|karov
תַּקְרִיב|takriv
קוֹרְבָּן|korban
קֶרֶב|kerev
קָרוֹן|karon
קֵרוּר|kerur
לְהַקְרִיחַ|lehakriach
קֶרַח|kerach
קֵירֵחַ|kereach
קָרַחַת|karachat
לְהִיקָּרוֹת|lehikarot
לִקְרוֹת|likrot
לְקָרוֹת|lekarot
מִקְרֶה|mikre
קִרְיָה|kirya
תַּקְרִית|takrit
תִּקְרָה|tikra
קַרְייָן|karyan
קָרוּי|karuy
לְהַקְרִים|lehakrim
לְהִיקָּרֵם|lehikarem
לִקְרוֹם|likrom
לִקְרוֹן|likron
לְהַקְרִין|lehakrin
הַקְרָנָה|hakrana
קֶרֶן|keren
קֶרֶן|keren
קְרִינָה|krina
לִקְרוֹס|likros
קַרְסוֹל|karsol
לִקְרוֹעַ|likroa
לְהִיקָּרֵעַ|lehikarea
קָרוּעַ|karua
לִקְרוֹץ|likrotz
לְקַרְצֵף|lekartzef
לְקַרְקֵעַ|lekarkea
קַרְקַע|karka
קַרְקָעִית|karka'it
קַרְקֶפֶת|karkefet
קִירְקוּף|kirkuf
לְקַרְקֵף|lekarkef
לְקַרְקֵר|lekarker
קָרִיר|karir
לְקָרֵר|lekarer
קַר|kar
לְהִתְקָרֵר|lehitkarer
קוֹר|kor
מְקָרֵר|mekarer
לְהִתְקָרֵשׁ|lehitkaresh
לְהַקְרִישׁ|lehakrish
קֶרֶשׁ|keresh
הַקְשָׁבָה|hakshava
לְהַקְשִׁיב|lehakshiv
קַשּׁוּב|kashuv
לְהַקְשִׁיחַ|lehakshiach
קָשׁוּחַ|kashuach
לְקַשֵּׁט|lekashet
לְהִתְקַשֵּׁט|lehitkashet
לִקְשׁוֹט|likshot
קִישּׁוּט|kishut
לְהִתְקַשּׁוֹת|lehitkashot
לְהַקְשׁוֹת|lehakshot
קָשֶׁה|kashe
קוֹשִׁי|koshi
לִקְשׁוֹת|likshot
לְקַשְׁקֵשׁ|lekashkesh
לְהִיקָּשֵׁר|lehikasher
לְקַשֵּׁר|lekasher
קֶשֶׁר|kesher
הֶקְשֵׁר|heksher
תִּקְשׁוֹרֶת|tikshoret
קָשׁוּר|kashur
לְהִתְקַשֵּׁר|lehitkasher
לִקְשׁוֹר|likshor
קִישּׁוּר|kishur
קִישּׁוּר|kishur
לְקוֹשֵׁשׁ|lekoshesh
לְקַשֵּׁת|lekashet
רֵיאָיוֹן|re'ayon
לִרְאוֹת|lir'ot
לְהֵירָאוֹת|lehera'ot
לְהַרְאוֹת|lehar'ot
רָאוּי|ra'uy
נִרְאֶה|nir'e
מַרְאָה|mar'a
לְהִתְרָאוֹת|lehitra'ot
לְרַאְייֵן|lerayen
לְהִתְרַאְייֵן|lehitrayen
בְּרֵאשִׁית|bereshit
רֵאשִׁית|reshit
רֵאשִׁית|reshit
רֹאשׁ|rosh
רִאשׁוֹן|rishon
בְּרֵאשִׁית|bereshit
רוֹב|rov
רִיבִּית|ribit
רַב|rav
רְבָבָה|revava
רִיבָּה|riba
מֵירַב|merav
מֵירַבִּי|merabi
רִיבּוּד|ribud
לְרַבֵּד|lerabed
תַּרְבּוּת|tarbut
לְהַרְבּוֹת|leharbot
לְהִתְרַבּוֹת|lehitrabot
לִרְבּוֹת|lirbot
הַרְבֵּה|harbe
רִיבּוּי|ribuy
רֶבַע|reva
רָבוּעַ|ravua
רְבִיעִי|revi'i
לְרַבֵּעַ|lerabea
רִיבּוּעַ|ribua
רוֹבַע|rova
לְהַרְבִּיעַ|leharbia
לִרְבּוֹץ|lirbotz
לְהַרְבִּיץ|leharbitz
לְהִתְרַבְרֵב|lehitravrev
רֶגֶב|regev
לִרְגּוֹז|lirgoz
לְהַרְגִּיז|lehargiz
לְהֵירָגֵז|leheragez
לְהִתְרַגֵּז|lehitragez
לְרַגֵּל|leragel
לְהַרְגִּיל|lehargil
רִיגּוּל|rigul
הֶרְגֵּל|hergel
רָגִיל|ragil
רֶגֶל|regel
תַּרְגִּיל|targil
לְהִתְרַגֵּל|lehitragel
לִרְגּוֹם|lirgom
מַרְגֵּמָה|margema
לִרְגּוֹן|lirgon
לְהַרְגִּיעַ|lehargia
לְהֵירָגֵעַ|leheragea
הַרְגָּעָה|harga'a
רָגוּעַ|ragua
רֶגַע|rega
רוֹגֵעַ|rogea
רוֹגַע|roga
לְהֵירָגֵשׁ|leheragesh
לְהַרְגִּישׁ|lehargish
לְרַגֵּשׁ|leragesh
לְהִתְרַגֵּשׁ|lehitragesh
הַרְגָּשָׁה|hargasha
הִתְרַגְּשׁוּת|hitragshut
רֶגֶשׁ|regesh
מַרְגָּשׁ|margash
רָגִישׁ|ragish
לִרְגּוֹשׁ|lirgosh
לְרַדֵּד|leraded
רָדוּד|radud
רָדוּד|radud
לִרְדּוֹת|lirdot
הֵירָדְמוּת|heradmut
לְהֵירָדֵם|leheradem
לְהַרְדִּים|lehardim
תַּרְדֵּמָה|tardema
לִרְדּוֹף|lirdof
לְהֵירָדֵף|leheradef
לְהַרְהִיב|leharhiv
לְרַהֵט|lerahet
רַהַט|rahat
רָהִיט|rahit
לִרְהוֹט|lirhot
רִיהוּט|rihut
מְרוּוָּח|meruvach
לִרְווֹחַ|lirvoach
לְרַווֵּחַ|leraveach
לְהַרְווִיחַ|leharviach
מִרְווָח|mirvach
רוּחַ|ruach
לְהִתְרַווֵּחַ|lehitraveach
לִרְווֹת|lirvot
לְהַרְווֹת|leharvot
לְהָרִים|leharim
רָמָה|rama
לְהִתְרוֹמֵם|lehitromem
לְרוֹמֵם|leromem
תְּרוּמָה|truma
מָרוֹם|marom
לְהָרִיעַ|leharia
לָרוּץ|larutz
לְהִתְרוֹצֵץ|lehitrotzetz
רִיצָה|ritza
מְרִיצָה|meritza
רָץ|ratz
לְהָרִיץ|leharitz
רַווָּק|ravak
רָז|raz
לִרְזוֹת|lirzot
לְהַרְזוֹת|leharzot
הַרְזָיָה|harzaya
רָזֶה|raze
לִרְחוֹב|lirchov
לְהַרְחִיב|leharchiv
לְהִתְרַחֵב|lehitrachev
רְחָבָה|rechava
הַרְחָבָה|harchava
רָחָב|rachav
רוֹחַב|rochav
רְחוֹב|rechov
לְרַחֵם|lerachem
לְהִתְרַחֵם|lehitrachem
רַחֲמִים|rachamim
לְרַחֵף|lerachef
לִרְחוֹץ|lirchotz
לְהֵירָחֵץ|leherachetz
רְחִיצָה|rechitza
תַּרְחִיץ|tarchitz
לְהִתְרַחֵץ|lehitrachetz
רָחוּץ|rachutz
לְהַרְחִיק|leharchik
הַרְחָקָה|harchaka
רָחוֹק|rachok
מֶרְחָק|merchak
לְהִתְרַחֵק|lehitrachek
מְרוּחָק|meruchak
לְרַחְרֵחַ|lerachreach
לִרְחוֹשׁ|lirchosh
לְהִתְרַחֵשׁ|lehitrachesh
לְהֵירָטֵב|leheratev
לְהַרְטִיב|lehartiv
לְהִתְרַטֵּב|lehitratev
רָטוֹב|ratov
רְטִיבוּת|retivut
לְהַרְטִיט|lehartit
לִרְטוֹט|lirtot
לְרַטֵּט|leratet
לִרְטוֹן|lirton
לְרַטֵּשׁ|leratesh
לָרִיב|lariv
מְרִיבָה|meriva
לְהָרִיחַ|lehariach
רֵיחַ|reach
רִימּוֹן|rimon
רִיס|ris
רֵיק|rek
לְהָרִיק|leharik
רִיק|rik
לְרוֹקֵן|leroken
לְהִתְרוֹקֵן|lehitroken
לָרִיר|larir
לְרַייֵּר|lerayer
רִיר|rir
לְרוֹשֵׁשׁ|leroshesh
לְהִתְרוֹשֵׁשׁ|lehitroshesh
לְהִתְרַכֵּב|lehitrakev
תִּרְכּוֹבֶת|tirkovet
לִרְכּוֹב|lirkov
הִתְרַכְּבוּת|hitrakvut
הֶרְכֵּב|herkev
הַרְכָּבָה|harkava
מוּרְכָּב|murkav
מְרוּכָּב|merukav
רֶכֶב|rechev
רַכֶּבֶת|rakevet
רְכִיב|rechiv
מֶרְכָּבָה|merkava
לְהַרְכִּיב|leharkiv
לְרַכֵּז|lerakez
לְהִתְרַכֵּז|lehitrakez
תַּרְכִּיז|tarkiz
מֶרְכָּז|merkaz
רַכָּז|rakaz
רִיכּוּז|rikuz
לְרַכֵּךְ|lerakech
לְהִתְרַכֵּךְ|lehitrakech
רִיכּוּךְ|rikuch
רַךְ|rach
לְרַכֵל|lerachel
לִרְכּוֹל|lirkol
לִרְכּוֹן|lirkon
לְהַרְכִּין|leharkin
לִרְכּוֹס|lirkos
לִרְכּוֹשׁ|lirkosh
לְהֵירָכֵשׁ|leherachesh
רְכִישָׁה|rechisha
רֶכֶשׁ|rechesh
רֶלֶווַנְטִי|relevanti
לְרַמֵּז|leramez
לִרְמוֹז|lirmoz
לְהֵירָמֵז|leheramez
רֶמֶז|remez
רַמְזוֹר|ramzor
רוֹמַח|romach
לְרַמּוֹת|leramot
לִרְמוֹת|lirmot
מִרְמָה|mirma
רַמַּאי|ramay
תַּרְמִיל|tarmil
לִרְמוֹס|lirmos
לְהֵירָמֵס|leherames
לִרְמוֹשׂ|lirmos
רֶמֶשׂ|remes
רְנָנָה|renana
רִינָּה|rina
לְהִתְרוֹנֵן|lehitronen
לְרַנֵּן|leranen
לְרַסֵּן|lerasen
לְרַסֵּס|lerases
רִיסּוּס|risus
לְרַסֵּק|lerasek
לְהִתְרַסֵּק|lehitrasek
הִתְרַסְּקוּת|hitraskut
רֶסֶק|resek
רֵעַ|rea
לִרְעוֹב|lir'ov
לְהַרְעִיב|lehar'iv
רָעָב|ra'av
רָעֵב|ra'ev
רְעַבְתָּן|re'avtan
לִרְעוֹד|lir'od
לְהַרְעִיד|lehar'id
רַעַד|ra'ad
לְהֵירָעֵד|lehera'ed
לִרְעוֹת|lir'ot
רַעֲיוֹן|ra'ayon
מִרְעֶה|mir'e
לְהַרְעִיל|lehar'il
הַרְעָלָה|har'ala
רַעַל|ra'al
רָעִיל|ra'il
תַּרְעֵלָה|tar'ela
לִרְעוֹם|lir'om
לְהַרְעִים|lehar'im
רַעַם|ra'am
לְהִתְרַעֵם|lehitra'em
לְרַעְנֵן|lera'anen
לְהִתְרַעְנֵן|lehitra'anen
רִיעְנוּן|ri'anun
רַעֲנָן|ra'anan
לְהָרֵעַ|leharea
לְהִתְרוֹעֵעַ|lehitro'ea
רַע|ra
לְהַרְעִיף|lehar'if
רַעַף|ra'af
לִרְעוֹץ|lir'otz
לְהֵירָעֵץ|lehera'etz
לִרְעוֹשׁ|lir'osh
לְהֵירָעֵשׁ|lehera'esh
לְהַרְעִישׁ|lehar'ish
רַעַשׁ|ra'ash
רוֹפֵא|rofe
לִרְפּוֹא|lirpo
לְהֵירָפֵא|leherafe
לְהִתְרַפֵּא|lehitrape
מִרְפָּאָה|mirpa'a
רְפוּאָה|refu'a
תְּרוּפָה|trufa
לְרַפֵּא|lerape
לְרַפֵּד|leraped
רִיפּוּד|ripud
לְהִתְרַפֵּט|lehitrapet
לְרַפֵּט|lerapet
לִרְפּוֹת|lirpot
לְרַפּוֹת|lerapot
לְהַרְפּוֹת|leharpot
רִפְיוֹן|rifyon
לְהִתְרַפֵּס|lehitrapes
מִרְפֶּסֶת|mirpeset
לְהִתְרוֹפֵף|lehitrofef
רַף|raf
מַרְפֵּק|marpek
לְהִתְרַפֵּק|lehitrapek
לְרַפְרֵף|lerafref
רִיפְרוּף|rifruf
רֶפֶשׁ|refesh
הַרְצָאָה|hartza'a
לְרַצֵּד|leratzed
רֶצַח|retzach
לִרְצוֹחַ|lirtzoach
לְהֵירָצֵחַ|leheratzeach
לִרְצוֹת|lirtzot
לְהִתְרַצּוֹת|lehitratzot
לְהַרְצוֹת|lehartzot
לְרַצּוֹת|leratzot
רָצוֹן|ratzon
רָצוּי|ratzuy
רְצִינִי|retzini
רְצִינִי|retzini
מַרְצֵעַ|martzea
לְרַצֵּף|leratzef
רִיצּוּף|ritzuf
רִצְפָּה|ritzpa
רָצִיף|ratzif
רָצִיף|ratzif
לְרוֹצֵץ|lerotzetz
רַק|rak
לִרְקוֹב|lirkov
לְהֵירָקֵב|leherakev
רָקָב|rakav
רִיקָּבוֹן|rikavon
רָקוּב|rakuv
לְהַרְקִיב|leharkiv
לִרְקוֹד|lirkod
לְרַקֵּד|leraked
רִיקּוּד|rikud
רַקְדָן|rakdan
רָקִיד|rakid
לְהַרְקִיד|leharkid
לִרְקוֹחַ|lirkoach
רוֹקֵחַ|rokeach
רוֹקְחוּת|rokchut
מִרְקַחַת|mirkachat
לְהִתְרַקֵּם|lehitrakem
לְהֵירָקֵם|leherakem
רִקְמָה|rikma
לִרְקוֹם|lirkom
לְהַרְקִיעַ|leharkia
רָקִיעַ|rakia
מִרְקָע|mirka
לְרַקֵּעַ|lerakea
רָקוּעַ|rakua
לִרְקוֹעַ|lirkoa
רַקָּה|raka
רַשַּׁאי|rashay
לְהַרְשׁוֹת|leharshot
רָשׁוּת|rashut
רְשׁוּת|reshut
רִישָּׁיוֹן|rishayon
לְהִתְרַשֵּׁל|lehitrashel
לְהֵירָשֵׁם|leherashem
לְהִתְרַשֵּׁם|lehitrashem
לְהַרְשִׁים|leharshim
הִתְרַשְּׁמוּת|hitrashmut
רִשְׁמִי|rishmi
הַרְשָׁמָה|harshama
תַּרְשִׁים|tarshim
רוֹשֶׁם|roshem
רְשִׁימָה|reshima
לִרְשׁוֹם|lirshom
רָשׁוּם|rashum
רִישּׁוּם|rishum
לְהַרְשִׁיעַ|leharshia
רָשָׁע|rasha
רֶשַׁע|resha
רִשְׁעָה|rish'a
הַרְשָׁעָה|harsha'a
מְרוּשָּׁע|merusha
רֶשֶׁף|reshef
לִרְשׁוֹף|lirshof
לְרַשְׁרֵשׁ|lerashresh
לְרוֹשֵׁשׁ|leroshesh
לְרוֹשֵׁשׁ|leroshesh
רֶשֶׁת|reshet
לִרְתּוֹחַ|lirtoach
לְהַרְתִּיחַ|lehartiach
לְהִתְרַתֵּחַ|lehitrateach
לְרַתּוֹת|leratot
לְרַתֵּךְ|leratech
רִיתּוּךְ|rituch
לִרְתּוֹם|lirtom
לְהֵירָתֵם|leheratem
לְהֵירָתֵעַ|leheratea
לְהַרְתִּיעַ|lehartia
מַרְתֵּף|martef
לְרַתֵּק|leratek
מְרַתֵּק|meratek
שֶׁ|she
לִשְׁאוֹב|lish'ov
לְהִישָּׁאֵב|lehisha'ev
מַשְׁאָב|mash'av
לִשְׁאוֹג|lish'og
לְהִשְׁתָּאוֹת|lehishta'ot
לִשְׁאוֹל|lish'ol
לְהַשְׁאִיל|lehash'il
לְהִישָּׁאֵל|lehisha'el
שְׁאֵלָה|she'ela
הַשְׁאָלָה|hash'ala
מִשְׁאָל|mish'al
שְׁאִילָה|she'ila
שָׁאוּל|sha'ul
מִשְׁאָלָה|mish'ala
לִשְׁאוֹף|lish'of
לְהִישָּׁאֵף|lehisha'ef
שְׁאִיפָה|she'ifa
לְהִישָּׁאֵר|lehisha'er
לְהַשְׁאִיר|lehash'ir
שְׁאָר|she'ar
שְׂאוֹר|se'or
שְׁאֵרִית|she'erit
שְׁבָב|shvav
שֶׁבַח|shevach
לְהַשְׁבִּיחַ|lehashbiach
לְשַׁבֵּחַ|leshabeach
לְהִשְׁתַּבֵּחַ|lehishtabeach
לְשַׁבֵּט|leshabet
לְהִישָּׁבוֹת|lehishavot
לִשְׁבּוֹת|lishbot
שִׁיבּוֹלֶת|shibolet
שְׁבִיל|shvil
שְׂבִיעָה|svi'a
לִשְׂבּוֹעַ|lisboa
לְהִישָּׁבֵעַ|lehishavea
לְהַשְׁבִּיעַ|lehashbia
שְׁבִיעִי|shvi'i
שְׁבוּעָה|shvu'a
שָׁבוּעַ|shavua
לְהַשְׂבִּיעַ|lehasbia
שָׂבֵעַ|savea
לְהִשְׁתַּבֵּץ|lehishtabetz
מִשְׁבֶּצֶת|mishbetzet
לְשַׁבֵּץ|leshabetz
לִשְׁבּוֹק|lishbok
לְשַׁבֵּר|leshaber
לִשְׁבּוֹר|lishbor
לְהִישָּׁבֵר|lehishaver
מִשְׁבָּר|mishbar
מַשְׁבֵּר|mashber
שֶׁבֶר|shever
שָׁבִיר|shavir
שָׁבוּר|shavur
לְהַשְׁבִּיר|lehashbir
לְהִשְׁתַּבֵּשׁ|lehishtabesh
לְשַׁבֵּשׁ|leshabesh
לְהַשְׁבִּית|lehashbit
שְׁבִיתָה|shvita
שַׁבָּת|shabat
לִשְׁבּוֹת|lishbot
שְׁגִיאָה|shgi'a
נִשְׂגָּב|nisgav
לִשְׁגּוֹג|lishgog
לְהַשְׁגִּיחַ|lehashgiach
הַשְׁגָּחָה|hashgacha
לִשְׁגּוֹת|lishgot
שָׁגוּי|shaguy
שִׁיגָּיוֹן|shigayon
מְשׁוּגָּע|meshuga
לְהִשְׁתַּגֵּעַ|lehishtagea
לְשַׁגֵּעַ|leshagea
שִׁיגָּעוֹן|shiga'on
לְשַׁגֵּר|leshager
שַׁגְרִיר|shagrir
שַׁגְרִירוּת|shagrirut
לְשַׂגְשֵׂג|lesagseg
שׁוֹד|shod
לִשְׁדּוֹד|lishdod
לְהִישָּׁדֵד|lehishaded
שָׂדֶה|sade
לְשַׁדֵּךְ|leshadech
שַׁדְכָן|shadchan
לְהִשְׁתַּדֵּךְ|lehishtadech
לְשַׁדֵּל|leshadel
לְהִשְׁתַּדֵּל|lehishtadel
לְשַׁדֵּר|leshader
מַשְׁדֵּר|mashder
מִשְׁדָּר|mishdar
לְשַׁדְרֵג|leshadreg
לְהִשְׁתַּדְרֵג|lehishtadreg
שֶׂה|se
לִשְׁהוֹת|lishhot
לְהַשְׁהוֹת|lehashhot
לְהִשְׁתַּהוֹת|lehishtahot
הַשְׁהָיָה|hashhaya
לְשַׁהֵק|leshahek
מִשְׁווָאָה|mishva'a
הַשְׁווָאָה|hashva'a
לְהָשִׁיב|lehashiv
תְּשׁוּבָה|tshuva
מָשׁוֹב|mashov
שׁוּב|shuv
לְהִשְׁתּוֹבֵב|lehishtovev
שִׁיבָה|shiva
לָשׁוּב|lashuv
מְשִׁיבוֹן|meshivon
שׁוֹבָב|shovav
לָשׂוּחַ|lasuach
לָשׁוּחַ|lashuach
שִׁיטָה|shita
לָשׁוּט|lashut
לְשׁוֹטֵט|leshotet
לְהָשִׁיט|lehashit
לְהִשְׁתַּוּוֹת|lehishtavot
לִשְׁווֹת|lishvot
לְהַשְׁווֹת|lehashvot
לְשַׁוּוֹת|leshavot
שׁוּלְחָן|shulchan
שׁוּלַייִם|shulayim
שׁוּם|shum
לְשַׁווֵּעַ|leshavea
לָשׁוּף|lashuf
לְהַשְׁווִיץ|lehashvitz
לְשַׁווֵּק|leshavek
שׁוּק|shuk
שׁוֹק|shok
תְּשׁוּקָה|tshuka
שִׁיוּוּק|shivuk
שׁוֹקוֹלָד|shokolad
שׁוֹקוֹלָדָה|shokolada
שׁוֹר|shor
תְּשׁוּרָה|tshura
לָשׁוּר|lashur
שׁוּרָה|shura
שׁוֹשֶׁלֶת|shoshelet
לְהִשְׁתַּזֵּף|lehishtazef
לִשְׁזוֹף|lishzof
לִשְׁזוֹר|lishzor
לְשַׁחֵד|leshached
שׁוֹחַד|shochad
לְהִשְׁתַּחֲווֹת|lehishtachavot
לְהַשְׁחִיז|lehashchiz
לְשַׁחְזֵר|leshachzer
לִשְׁחוֹט|lishchot
לְהִישָּׁחֵט|lehishachet
לִשְׁחוֹת|lishchot
לִשְׂחוֹת|lischot
שַׂחְייָן|sachyan
מִשְׂחֶה|mische
לְהִשְׁתַּחֵל|lehishtachel
לְהַשְׁחִיל|lehashchil
שָׁחוּם|shachum
לְהַשְׁחִים|lehashchim
שַׁחְמָט|shachmat
שַׁחֶפֶת|shachefet
שַׁחַץ|shachatz
שַׁחְצָן|shachtzan
לְשַׂחֵק|lesachek
לִשְׁחוֹק|lishchok
לְהִישָּׁחֵק|lehishachek
מִשְׂחָק|mischak
שַׂחְקָן|sachkan
שָׁחוּק|shachuk
לְהַשְׁחִיר|lehashchir
הַשְׁחָרָה|hashchara
שָׁחוֹר|shachor
שַׁחַר|shachar
לְשַׁחֵר|leshacher
לְהִשְׁתַּחְרֵר|lehishtachrer
לְשַׁחְרֵר|leshachrer
שִׁיחְרוּר|shichrur
לְהִישָּׁחֵת|lehishachet
לְהַשְׁחִית|lehashchit
לְשַׁחֵת|leshachet
שְׁחִיתוּת|shchitut
לִשְׁטוֹחַ|lishtoach
שֶׁטַח|shetach
שָׁטִיחַ|shatiach
לְהִשְׁתַּטֵּחַ|lehishtateach
שָׁטוּחַ|shatuach
לְהִשְׁתַּטּוֹת|lehishtatot
לְשַׁטּוֹת|leshatot
שְׁטוּת|shtut
שׁוֹטֶה|shote
לִשְׁטוֹף|lishtof
לְהִישָּׁטֵף|lehishatef
שִׁיטָּפוֹן|shitafon
מִשְׁטָר|mishtar
שׁוֹטֵר|shoter
מִשְׁטָרָה|mishtara
לְשַׁטֵּר|leshater
שְׁטְרוּדֶל|shtrudel
שֵׂיָה|seya
לָשִׂיחַ|lasiach
לְהָשִׂיחַ|lehasiach
לְשׂוֹחֵחַ|lesocheach
שִׂיחָה|sicha
שִׂיחַ|siach
לְשַׁייֵּט|leshayet
שַׁייָּט|shayat
שִׁיּוּט|shiyut
שַׁיִט|shayit
לְשַׁייֵּךְ|leshayech
לְהִשְׁתַּייֵּךְ|lehishtayech
שַׁייָּךְ|shayach
לָשִׂים|lasim
לְהָשִׂים|lehasim
מְשִׂימָה|mesima
הֲשָׂמָה|hasama
לְשַׁייֵּף|leshayef
לָשִׁיר|lashir
לְשׁוֹרֵר|leshorer
מוּשָׁר|mushar
שִׁיר|shir
שִׁירָה|shira
לָשׂוּשׂ|lasus
שִׁישִּׁי|shishi
לְהָשִׁית|lehashit
לָשִׁית|lashit
לִשְׁכַּב|lishkav
מִשְׁכָּב|mishkav
לְהַשְׁכִּיב|lehashkiv
שִׁכְבָה|shichva
לִשְׁכּוֹחַ|lishkoach
שָׁכִיחַ|shachiach
לְהִישָּׁכֵחַ|lehishacheach
לְהַשְׁכִּיחַ|lehashkiach
לְהִשְׁתַּכֵּחַ|lehishtakeach
שְׁכִיחוּת|shchichut
לָשׁוֹךְ|lashoch
לְשַׁכֵּךְ|leshakech
לִשְׁכּוֹל|lishkol
לְהַשְׂכִּיל|lehaskil
שֵׂכֶל|sechel
שַׁכּוּל|shakul
שְׂכַלְתָּן|schaltan
שֵׂכֶל|sechel
אֶשְׁכּוֹל|eshkol
אֶשְׁכּוֹלִית|eshkolit
לְשַׁכְלֵל|leshachlel
לְהִשְׁתַּכְלֵל|lehishtachlel
מְשׁוּכְלָל|meshuchlal
שִׁיכְלוּל|shichlul
הִשְׁתַּכְלְלוּת|hishtachlelut
לְהַשְׁכִּים|lehashkim
לִשְׁכּוֹן|lishkon
לְהַשְׁכִּין|lehashkin
לְהִשְׁתַּכֵּן|lehishtaken
שָׁכֵן|shachen
שְׁכוּנָה|shchuna
מִשְׁתַּכֵּן|mishtaken
לְשַׁכֵּן|leshaken
שָׁכֵן|shachen
מַשְׁכַּנְתָּה|mashkanta
מִשְׁכָּן|mishkan
לְשַׁכְנֵעַ|leshachnea
לְהִשְׁתַּכְנֵעַ|lehishtachnea
שִׁיכְנוּעַ|shichnua
לְשַׁכְפֵּל|leshachpel
לִשְׂכּוֹר|liskor
לְהִישָּׂכֵר|lehisacher
לְהַשְׂכִּיר|lehaskir
לְהִשְׂתַּכֵּר|lehistaker
מַשְׂכּוֹרֶת|maskoret
הַשְׂכָּרָה|haskara
שְׂכִירָה|schira
שָׂכָר|sachar
לְהִשְׁתַּכֵּר|lehishtaker
לְשַׁכֵּר|leshaker
שָׂכוּר|sachur
שְׂכִירוּת|schirut
לְהַשְׁכִּישׁ|lehashkish
לְהִשְׁתַּכְשֵׁךְ|lehishtachshech
לְשַׁכְשֵׁךְ|leshachshech
לְשַׁכְתֵּב|leshachtev
שֶׁל|shel
לְשַׁלֵּב|leshalev
תִּשְׁלוֹבֶת|tishlovet
שָׁלָב|shalav
מִשְׁלָב|mishlav
שִׁילּוּב|shiluv
לְהִשְׁתַּלֵּב|lehishtalev
שֶׁלֶג|sheleg
מוּשְׁלָג|mushlag
אַשְׁלָג|ashlag
אַשְׁלְגַן|ashlegan
שֶׁלֶד|sheled
שַׁלְהֶבֶת|shalhevet
לְהִשְׁתַּלְהֵב|lehishtalhev
לְשַׁלְהֵב|leshalhev
שַׁלְווָה|shalva
שָׁלֵו|shalev
לְהִישָּׁלֵחַ|lehishaleach
לְהִשְׁתַּלֵּחַ|lehishtaleach
שָׁלוּחַ|shaluach
לִשְׁלוֹחַ|lishloach
לְשַׁלֵּחַ|leshaleach
שָׁלִיחַ|shaliach
לִשְׁלוֹט|lishlot
לְהִישָּׁלֵט|lehishalet
לְהַשְׁלִיט|lehashlit
שַׁלִּיט|shalit
שַׁלִּיט|shalit
שִׁלְטוֹן|shilton
שֶׁלֶט|shelet
לְהִשְׁתַּלֵּט|lehishtalet
לְהַשְׁלִיט|lehashlit
שַׁלָּט|shalat
לְשַׁלְטֵט|leshaltet
לִשְׁלוֹת|lishlot
לְהִישָּׁלוֹת|lehishalot
לְהַשְׁלוֹת|lehashlot
אַשְׁלָיָה|ashlaya
לְהַשְׁלִיךְ|lehashlich
הַשְׁלָכָה|hashlacha
שַׁלֶּכֶת|shalechet
לְהִישָּׁלֵל|lehishalel
לְהִשְׁתּוֹלֵל|lehishtolel
שְׁלִילִי|shlili
הִשְׁתּוֹלְלוּת|hishtolelut
לִשְׁלוֹל|lishlol
לְהִשְׁתַּלֵּם|lehishtalem
לְהַשְׁלִים|lehashlim
לְשַׁלֵּם|leshalem
לִשְׁלוֹם|lishlom
שָׁלוֹם|shalom
שָׁלֵם|shalem
תַּשְׁלוּם|tashlum
הַשְׁלָמָה|hashlama
לְהִישָּׁלֵם|lehishalem
הִשְׁתַּלְּמוּת|hishtalmut
לְהִישָּׁלֵף|lehishalef
לִשְׁלוֹף|lishlof
שְׁלִיף|shlif
לִשְׁלוֹק|lishlok
לְשַׁלֵּשׁ|leshalesh
שְׁלִישִׁי|shlishi
שְׁלִישׁ|shlish
שְׁלִישִׁיָּה|shlishiya
שִׁלְשׁוֹם|shilshom
לְהִשְׁתַּלְשֵׁל|lehishtalshel
שַׁלְשֶׁלֶת|shalshelet
לְשַׁלְשֵׁל|leshalshel
שָׁם|sham
שֵׁם|shem
לְהִישָּׁמֵד|lehishamed
לְהַשְׁמִיד|lehashmid
הַשְׁמָדָה|hashmada
לְהִשְׁתַּמֵּד|lehishtamed
לִשְׂמוֹחַ|lismoach
לְשַׂמֵּחַ|lesameach
שִׂמְחָה|simcha
שָׂמֵחַ|sameach
לִשְׁמוֹט|lishmot
לְהִישָּׁמֵט|lehishamet
לְהַשְׁמִיט|lehashmit
לְהִשְׁתַּמֵּט|lehishtamet
שַׁמַּאי|shamay
שָׁמַייִם|shamayim
שָׁמַיִם|shamayim
שְׂמִיכָה|smicha
שִׂמְלָה|simla
לְהִשְׁתּוֹמֵם|lehishtomem
לְהִישּׁוֹם|lehishom
לְהָשֵׁם|lehashem
לָשׁוֹם|lashom
לְהַשְׁמִין|lehashmin
שָׁמֵן|shamen
לְשַׁמֵּן|leshamen
לִשְׁמוֹן|lishmon
שֶׁמֶן|shemen
שַׁמֶּנֶת|shamenet
שְׁמִינִי|shmini
לִשְׁמוֹעַ|lishmoa
לְהִישָּׁמֵעַ|lehishamea
לְהַשְׁמִיעַ|lehashmia
לְהִשְׁתַּמֵּעַ|lehishtamea
מַשְׁמָעוּתִי|mashma'uti
שְׁמוּעָה|shmu'a
מִשְׁמַעַת|mishma'at
מַשְׁמָע|mashma
מַשְׁמָעוּת|mashma'ut
שְׁמִיעָה|shmi'a
שִׁימּוּעַ|shimua
לְהַשְׁמִיץ|lehashmitz
שֶׁמֶץ|shemetz
לְהִישָּׁמֵר|lehishamer
לְשַׁמֵּר|leshamer
לְהִשְׁתַּמֵּר|lehishtamer
מִשְׁמֶרֶת|mishmeret
מִשְׁמָר|mishmar
שְׁמִירָה|shmira
שָׁמוּר|shamur
לִשְׁמוֹר|lishmor
שִׁימּוּר|shimur
שְׁמָרִים|shmarim
לְשַׁמֵּשׁ|leshamesh
שָׁמִישׁ|shamish
לְהִשְׁתַּמֵּשׁ|lehishtamesh
שִׁימּוּשִׁי|shimushi
שֵׁמֶשׁ|shemesh
שִׁימּוּשׁ|shimush
תַּשְׁמִישׁ|tashmish
שִׁמְשִׁייָּה|shimshiya
לְהַשְׂנִיא|lehasni
לִשְׂנוֹא|lisno
שִׂנְאָה|sin'a
שָׂנוּא|sanu
שָׁנָה|shana
שֶׁנְהַבִּי|shenhabi
שֶׁנְהָב|shenhav
שַׁנְהֶבֶת|shanhevet
שִׁינּוּי|shinuy
לְשַׁנּוֹת|leshanot
לְהִשְׁתַּנּוֹת|lehishtanot
תַּשְׁנִית|tashnit
לִשְׁנוֹת|lishnot
לְהִישָּׁנוֹת|lehishanot
שׁוֹנִי|shoni
שֵׁנִי|sheni
מְשׁוּנֶּה|meshune
שָׁנִי|shani
לְשַׁנֵּן|leshanen
שֵׁן|shen
לְשַׁנֵּעַ|leshanea
לְהִשְׁתַּנֵּק|lehishtanek
לְהִישָּׁנֵק|lehishanek
לְשַׁנֵּק|leshanek
לְשַׁסּוֹת|leshasot
לְשַׁסֵּעַ|leshasea
לִשְׁסוֹעַ|lishsoa
לְשַׁסֵּף|leshasef
לְהִשְׁתַּעְבֵּד|lehishta'abed
הִשְׁתַּעְבְּדוּת|hishta'abdut
לְשַׁעְבֵּד|lesha'abed
שִׁיעְבּוּד|shi'abud
לִשְׁעוֹט|lish'ot
לִשְׁעוֹת|lish'ot
לְהַשְׁעוֹת|lehash'ot
שָׁעוֹן|sha'on
שָׁעָה|sha'a
לְהִשְׁתַּעֵל|lehishta'el
מִשְׁעוֹל|mish'ol
לְשַׁעְמֵם|lesha'amem
לְהִשְׁתַּעְמֵם|lehishta'amem
מְשׁוּעְמָם|meshu'amam
מְשַׁעְמֵם|mesha'amem
לְהַשְׁעִין|lehash'in
לְהִישָּׁעֵן|lehisha'en
לְשַׁעֵר|lesha'er
שִׁיעוּר|shi'ur
שַׁעַר|sha'ar
שׁוֹעֵר|sho'er
שֵׂיעָר|se'ar
שַׂעֲרָה|sa'ara
שָׂעִיר|sa'ir
לְהַשְׂעִיר|lehas'ir
לְשַׁעְשֵׁעַ|lesha'ashea
לְהִשְׁתַּעְשֵׁעַ|lehishta'ashea
שַׁעְשׁוּעַ|sha'ashua
לְשַׁעְתֵּק|lesha'atek
מִשְׁפָּחָה|mishpacha
שִׁפְחָה|shifcha
לִשְׁפּוֹט|lishpot
לְהִישָּׁפֵט|lehishafet
שִׁיפּוּט|shiput
מִשְׁפָּט|mishpat
מִשְׁפָּטִי|mishpati
שָׁפוּי|shafuy
שָׂפָה|safa
שָׂפָה|safa
לְהִישָּׁפֵךְ|lehishafech
שָׁפוּךְ|shafuch
לְהִשְׁתַּפֵּךְ|lehishtapech
לִשְׁפּוֹךְ|lishpoch
לִשְׁפּוֹל|lishpol
לְהַשְׁפִּיל|lehashpil
הַשְׁפָּלָה|hashpala
לְהִשְׁתַּפֵּל|lehishtapel
שָׂפָם|safam
מְשׂוּפָּם|mesupam
שָׁפָן|shafan
לְהִשְׁתַּפֵן|lehishtafen
לִשְׁפּוֹעַ|lishpoa
לְהַשְׁפִּיעַ|lehashpia
הַשְׁפָּעָה|hashpa'a
שֶׁפַע|shefa
שִׁפְעָה|shif'a
שַׁפַּעַת|shapa'at
לְשַׁפֵּעַ|leshapea
שִׁיפּוּעַ|shipua
מְשׁוּפָּע|meshupa
לְשַׁפְעֵל|leshaf'el
לְהִשְׁתַּפְעֵל|lehishtaf'el
לְשַׁפֵּץ|leshapetz
שִׁיפּוּץ|shiputz
שִׁיפּוּר|shipur
לְשַׁפֵּר|leshaper
לְהִשְׁתַּפֵּר|lehishtaper
שַׁפִּיר|shapir
לְהַשְׁפְּרִיץ|lehashpritz
לְשַׁפְשֵׁף|leshafshef
לְהִשְׁתַּפְשֵׁף|lehishtafshef
שִׁיפְשׁוּף|shifshuf
לִשְׁפּוֹת|lishpot
שַׂק|sak
לִשְׁקוֹד|lishkod
שֶׁקֶט|sheket
לְהַשְׁקִיט|lehashkit
שָׁקֵט|shaket
לִשְׁקוֹט|lishkot
לְהַשְׁקוֹת|lehashkot
הַשְׁקָיָה|hashkaya
מַשְׁקֶה|mashke
שַׂקִּית|sakit
לְהִישָּׁקֵל|lehishakel
שֶׁקֶל|shekel
מִשְׁקָל|mishkal
שִׁיקּוּל|shikul
שְׁקִילָה|shkila
לִשְׁקוֹל|lishkol
לְשַׁקְלֵל|leshaklel
שִׁיקְלוּל|shiklul
לְשַׁקֵּם|leshakem
לְהִשְׁתַּקֵּם|lehishtakem
שִׁיקּוּם|shikum
לִשְׁקוֹעַ|lishkoa
לְהַשְׁקִיעַ|lehashkia
שֶׁקַע|sheka
הַשְׁקָעָה|hashka'a
לְהִשְׁתַּקֵּעַ|lehishtakea
לְהִישָּׁקֵף|lehishakef
לְשַׁקֵּף|leshakef
לְהִשְׁתַּקֵּף|lehishtakef
לְהַשְׁקִיף|lehashkif
שֶׁקֶף|shekef
שְׁקוּפִית|shkufit
הַשְׁקָפָה|hashkafa
שִׁיקּוּף|shikuf
שָׁקוּף|shakuf
מִשְׁקָפַייִם|mishkafayim
הִשְׁתַּקְּפוּת|hishtakfut
שְׁקִיפוּת|shkifut
שִׁיקּוּץ|shikutz
לָשׁוֹק|lashok
לְהִשְׁתּוֹקֵק|lehishtokek
לְשַׁקֵּר|leshaker
שַׁקְרָן|shakran
שֶׁקֶר|sheker
לְשַׁקְשֵׁק|leshakshek
הַשְׁרָאָה|hashra'a
לְשַׁרְבֵּב|lesharbev
לְהִשְׁתַּרְבֵּב|lehishtarbev
לְשַׁרְבֵּט|lesharbet
שַׁרְבִיט|sharvit
לְהִשְׂתָּרֵג|lehistareg
לִשְׂרוֹד|lisrod
הִישָּׂרְדוּת|hisardut
מִשְׂרָד|misrad
לִשְׂרוֹט|lisrot
לְהִישָּׂרֵט|lehisaret
לְשַׂרְטֵט|lesartet
שִׂירְטוּט|sirtut
לְהַשְׁרוֹת|lehashrot
מִשְׂרָה|misra
לִשְׁרוֹת|lishrot
לִשְׂרוֹת|lisrot
שִׁרְיוֹן|shiryon
לְשַׁרְייֵן|lesharyen
שִׁירְיוּן|shiryun
שְׂרוֹךְ|sroch
לִשְׂרוֹךְ|lisroch
שְׂרוֹךְ|sroch
שָׂרוּךְ|saruch
לְהִשְׂתָּרֵךְ|lehistarech
לְהִישָּׂרֵךְ|lehisarech
לְהִשְׂתָּרֵעַ|lehistarea
לִשְׂרוֹף|lisrof
לְהִישָּׂרֵף|lehisaref
שְׂרֵיפָה|srefa
שָׂרָף|saraf
לִשְׁרוֹץ|lishrotz
לִשְׁרוֹק|lishrok
לִשְׂרוֹר|lisror
לְהִשְׂתָּרֵר|lehistarer
שָׂר|sar
לְהִשְׁתָּרֵשׁ|lehishtaresh
לְהַשְׁרִישׁ|lehashrish
שׁוֹרֶשׁ|shoresh
לְשָׁרֵשׁ|lesharesh
לְשַׁרְשֵׁר|lesharsher
שַׁרְשֶׁרֶת|sharsheret
לְשָׁרֵת|lesharet
שֵׁירוּת|sherut
לִשְׁתּוֹת|lishtot
שַׁתְייָן|shatyan
שְׁתִיָּה|shtiya
לְהִישָּׁתוֹת|lehishatot
שָׁתוּי|shatuy
לִשְׁתּוֹל|lishtol
לְהִישָּׁתֵל|lehishatel
לְהַשְׁתִּיל|lehashtil
שְׁתִילָה|shtila
מַשְׁתֵּן|mashten
לְהַשְׁתִּין|lehashtin
שֶׁתֶן|sheten
לְשַׁתֵּף|leshatef
לְהִשְׁתַּתֵּף|lehishtatef
שִׁיתּוּף|shituf
מְשׁוּתָּף|meshutaf
הִשְׁתַּתְּפוּת|hishtatfut
לִשְׁתּוֹק|lishtok
לְשַׁתֵּק|leshatek
לְהַשְׁתִּיק|lehashtik
לְהִשְׁתַּתֵּק|lehishtatek
שְׁתִיקָה|shtika
לִשְׁתּוֹת|lishtot
לְהַשְׁתִּית|lehashtit
תָּא|ta
לִתְאוֹב|lit'ov
תֵּיאָבוֹן|te'avon
לִתְאוֹם|lit'om
לְתָאֵם|leta'em
לְהַתְאִים|lehat'im
הַתְאָמָה|hat'ama
תְּאוֹם|te'om
תֵּיאוּם|te'um
לְתָאֵר|leta'er
תֵּיאוּר|te'ur
תּוֹאַר|to'ar
לְתַאֲרֵךְ|leta'arech
לְתַבֵּל|letabel
תַּבְלִין|tavlin
תֵּבֵל|tevel
תֶּבֶל|tevel
לִתְבּוֹעַ|litboa
לְהִיתָּבֵעַ|lehitavea
תְּבִיעָה|tvi'a
תּוֹבֵעַ|tovea
לְתַגְבֵּר|letagber
לְתַגְמֵל|letagmel
לְתַדְלֵק|letadlek
תֶּדֶר|teder
לְתַדְרֵךְ|letadrech
תֵּה|te
לִתְהוֹת|lithot
תְּהִיָּה|tehiya
תּוֹהוּ|tohu
תּוֹחֶלֶת חַיִּים|tocheletchayim
מִתְווֶה|mitve
תְּווַאי|tvay
לְהַתְווֹת|lehatvot
תְּווִייָּה|tviya
לְתַווֵּךְ|letavech
תִּיוּוּךְ|tivuch
תָּווֶךְ|tavech
תּוּכִּי|tuki
לָתוּר|latur
תּוֹר|tor
תּוּשִׁייָּה|tushiya
תּוּת|tut
לְתַזְמֵן|letazmen
תִּיזְמוּן|tizmun
לִתְחוֹב|litchov
לְהִיתָּחֵב|lehitachev
לְתַחְזֵק|letachzek
מְתוּחְכָּם|metuchkam
לְהַתְחִיל|lehatchil
הַתְחָלָה|hatchala
לִתְחוֹם|litchom
לְתַחֵם|letachem
מִתְחָם|mitcham
תְּחוּם|tchum
לְתַחְמֵן|letachmen
לְתַחְקֵר|letachker
תַּחַת|tachat
תֵּיאוֹרְיָה|te'orya
תֵּיאַטְרוֹן|te'atron
לְתַייֵּג|letayeg
תִּיק|tik
לְתַייֵּק|letayek
תִּיקִייָּה|tikiya
תֵּיקוֹ|teko
לְתַייֵּר|letayer
תַּייָּר|tayar
תַּייָּרוּת|tayarut
תִּירָס|tiras
תַּיִשׁ|tayish
לְתַכֵּן|letaken
לְהִיתָּכֵן|lehitachen
תּוֹכְנָה|tochna
תֶּכֶן|techen
תּוֹכֶן|tochen
תּוֹכְנִית|tochnit
מַתְכּוֹן|matkon
לִתְכּוֹן|litkon
לְתַכְנֵן|letachnen
לְתַכְנֵת|letachnet
מְתַכְנֵת|metachnet
תִּיכְנוּת|tichnut
תְּכוּפוֹת|tchufot
תָּכוּף|tachuf
לִתְכּוֹף|litkof
לִתְלוֹת|litlot
לְהִיתָּלוֹת|lehitalot
לְהַתְלוֹת|lehatlot
תִּלְיוֹן|tilyon
תְּלוּת|tlut
תָּלוּי|taluy
תְּלִייָּה|tliya
לִתְלוֹשׁ|litlosh
לְהִיתָּלֵשׁ|lehitalesh
לְתַלְתֵּל|letaltel
מְתוּלְתָּל|metultal
תַּלְתָּל|taltal
לְהַתְמִיד|lehatmid
מַתְמִיד|matmid
לִתְמוֹהַּ|litmoah
לְהַתְמִיהַּ|lehatmiah
לְתַמְחֵר|letamcher
תָּמִיד|tamid
לְהִיתָּמֵךְ|lehitamech
תְּמִיכָה|tmicha
לִתְמוֹךְ|litmoch
לָתוֹם|latom
תָּמִים|tamim
לְהִיתַּמֵּם|lehitamem
תָּם|tam
לְתַמְצֵת|letamtzet
לְהִיתַּמֵּר|lehitamer
תִּמְרוֹן|timron
לְתַמְרֵן|letamren
לְתַמְרֵץ|letamretz
תְּנַאי|tnay
לְהַתְנוֹת|lehatnot
לְתַנּוֹת|letanot
תִּנְייָנִי|tinyani
תַּנִּין|tanin
לְהַתְנִיעַ|lehatnia
לְתַסְכֵּל|letaskel
תִּיסְכּוּל|tiskul
לִתְסוֹס|litsos
לְהַתְסִיס|lehatsis
תְּסִיסָה|tsisa
תַּסָּס|tasas
לְתַעֵב|leta'ev
לְהִיתָּעֵב|lehita'ev
לְתַעֵד|leta'ed
תִּיעוּד|ti'ud
לִתְעוֹת|lit'ot
לְהַתְעוֹת|lehat'ot
לְתַעֵשׂ|leta'es
לְתַעְתֵּעַ|leta'atea
תַּפּוּז|tapuz
תְּפִיחָה|tficha
לִתְפּוֹחַ|litpoach
לְהַתְפִּיחַ|lehatpiach
לְהַתְפִּיל|lehatpil
תָּפֵל|tafel
הַתְפָּלָה|hatpala
לִתְפּוֹשׂ|litpos
לְהִיתָּפֵשׂ|lehitafes
תְּפִיסָה|tfisa
תָּפוּס|tafus
תִּיפְעוּלִי|tif'uli
תִּיפְעוּל|tif'ul
לְתַפְעֵל|letaf'el
לְתוֹפֵף|letofef
תּוֹף|tof
לְתַפְקֵד|letafked
תָּפוּר|tafur
לִתְפּוֹר|litpor
תְּפִירָה|tfira
תֶּפֶר|tefer
מִתְפָּרָה|mitpara
תְּפִישָׂה|tfisa
לְהִיתָּקֵל|lehitakel
לְהַתְקִיל|lehatkil
לְתַקֵּן|letaken
לְהַתְקִין|lehatkin
לְהִיתַּקֵּן|lehitaken
תֶּקֶן|teken
תַּקִּין|takin
הַתְקָנָה|hatkana
תִּקְנִי|tikni
לְתַקְנֵן|letaknen
תֶּקַע|teka
לִתְקוֹעַ|litkoa
לְהִיתָּקֵעַ|lehitakea
תִּיקּוּף|tikuf
תָּקֵף|takef
לְהַתְקִיף|lehatkif
מִתְקָפָה|mitkafa
לִתְקוֹף|litkof
לְהִיתָּקֵף|lehitakef
תּוֹקֶף|tokef
הֶתְקֵף|hetkef
לְתַקֵּף|letakef
לְתַקְצֵב|letaktzev
תִּיקְשׁוּר|tikshur
לְתַקְשֵׁר|letaksher
תִּיקְתּוּק|tiktuk
לְתַקְתֵּק|letaktek
לְתַרְגֵּל|letargel
תִּירְגּוּל|tirgul
תִּירְגּוּם|tirgum
לְתַרְגֵּם|letargem
תַּרְגּוּם|targum
מְתוּרְגְּמָן|meturgeman
מְתַרְגֵּם|metargem
תּוּרְגְּמָן|turgeman
לְהַתְרוֹת|lehatrot
לִתְרוֹם|litrom
לְהִיתָּרֵם|lehitarem
תַּרְנְגוֹל|tarnegol
תַּרְנְגוֹלֶת|tarnegolet
לְהַתְרִיס|lehatris
תְּרִיס|tris
לְהַתְרִיעַ|lehatria
לְתָרֵץ|letaretz
תֵּירוּץ|terutz
לְתַשְׁאֵל|letash'el
תְּשִׁיעִי|tshi'i
תֶּשֶׁר|tesher
לִתְשׁוֹשׁ|litshosh
